"lang"਍笀ഀഀ
"Language"	"vietnamese"਍∀吀漀欀攀渀猀∀ഀഀ
{਍∀䜀愀洀攀唀䤀开刀攀瘀攀爀猀攀䴀漀甀猀攀∀ऀ∀ကꌁ漞 渀最뀀挞 挀栀甀琞∀ഀഀ
"[english]GameUI_ReverseMouse"	"Reverse mouse"਍∀䜀愀洀攀唀䤀开刀攀瘀攀爀猀攀䴀漀甀猀攀䰀愀戀攀氀∀ऀ∀ကꌁ漞 渀最뀀挞 琀爀挞 氀渀ⴀ砀甀턀渞最 挀愞 挀栀甀琞∀ഀഀ
"[english]GameUI_ReverseMouseLabel"	"Reverse mouse up-down axis"਍∀䜀愀洀攀唀䤀开䴀漀甀猀攀䰀漀漀欀∀ऀ∀一栀渀 戀넀渞最 挀栀甀琞∀ഀഀ
"[english]GameUI_MouseLook"	"Mouse look"਍∀䜀愀洀攀唀䤀开䴀漀甀猀攀䰀漀漀欀䰀愀戀攀氀∀ऀ∀匀„搀渞最 挀栀甀琞 ᄀ쌁„渀栀渀 砀甀渀最 焀甀愀渀栀∀ഀഀ
"[english]GameUI_MouseLookLabel"	"Use the mouse to look around"਍∀䜀愀洀攀唀䤀开䴀漀甀猀攀䘀椀氀琀攀爀∀ऀ∀䈀„氀촀挞 挀栀甀琞∀ഀഀ
"[english]GameUI_MouseFilter"	"Mouse filter"਍∀䜀愀洀攀唀䤀开䴀漀甀猀攀䘀椀氀琀攀爀䰀愀戀攀氀∀ऀ∀䰀洀 洀뀀琞 挀栀甀礀쌀渞 ᄀ渞最 挀栀甀琞 焀甀愀 ㈀ 欀栀甀渀最 栀渀栀⸀∀ഀഀ
"[english]GameUI_MouseFilterLabel"	"Smooth out mouse movement over 2 frames."਍∀䜀愀洀攀唀䤀开䴀漀甀猀攀匀攀渀猀椀琀椀瘀椀琀礀∀ऀ∀က„渀栀ꄀ礞 挀栀甀琞∀ഀഀ
"[english]GameUI_MouseSensitivity"	"Mouse sensitivity"਍∀䜀愀洀攀唀䤀开䨀漀礀猀琀椀挀欀∀ऀ∀吀愀礀 挀꜀洞∀ഀഀ
"[english]GameUI_Joystick"	"Gamepad"਍∀䜀愀洀攀唀䤀开䨀漀礀猀琀椀挀欀䰀愀戀攀氀∀ऀ∀䈀관琞 琀愀礀 挀꜀洞∀ഀഀ
"[english]GameUI_JoystickLabel"	"Enable the gamepad"਍∀䜀愀洀攀唀䤀开刀攀瘀攀爀猀攀䨀漀礀猀琀椀挀欀∀ऀ∀ကꌁ漞 渀最뀀挞 琀爀挞 氀渀ⴀ砀甀턀渞最 挀愞 琀愀礀 挀꜀洞∀ഀഀ
"[english]GameUI_ReverseJoystick"	"Reverse gamepad up-down axis"਍∀䜀愀洀攀唀䤀开䨀漀礀猀琀椀挀欀䰀漀漀欀∀ऀ∀一栀渀 焀甀愀 挀꜀渞 ᄀ椁섀甞 欀栀椀쌀渞∀ഀഀ
"[english]GameUI_JoystickLook"	"Joystick look"਍∀䜀愀洀攀唀䤀开䨀漀礀猀琀椀挀欀䰀漀漀欀䰀愀戀攀氀∀ऀ∀匀„搀渞最 琀愀礀 挀꜀洞 ᄀ쌁„渀栀渀 砀甀渀最 焀甀愀渀栀∀ഀഀ
"[english]GameUI_JoystickLookLabel"	"Use the gamepad to look around"਍∀䜀愀洀攀唀䤀开䨀漀礀猀琀椀挀欀䰀漀漀欀吀礀瀀攀∀ऀ∀䌀挀栀 琀栀挞 渀栀渀∀ഀഀ
"[english]GameUI_JoystickLookType"	"Look type"਍∀䜀愀洀攀唀䤀开䨀漀礀猀琀椀挀欀一漀爀洀愀氀∀ऀ∀䈀渀栀 琀栀뀀?渞最∀ഀഀ
"[english]GameUI_JoystickNormal"	"Normal"਍∀䜀愀洀攀唀䤀开䨀漀礀猀琀椀挀欀䤀渀瘀攀爀琀攀搀∀ऀ∀一最뀀挞 挀栀椀섀甞∀ഀഀ
"[english]GameUI_JoystickInverted"	"Inverted"਍∀䜀愀洀攀唀䤀开䨀漀礀猀琀椀挀欀䴀漀瘀攀䰀漀漀欀匀琀椀挀欀猀∀ऀ∀䌀꜀渞 搀椀 挀栀甀礀쌀渞⼀渀栀渀∀ऀ嬀␀圀䤀一㌀㈀崀ഀഀ
"[english]GameUI_JoystickMoveLookSticks"	"Move/Look sticks"਍∀䜀愀洀攀唀䤀开䨀漀礀猀琀椀挀欀䴀漀瘀攀䰀漀漀欀匀琀椀挀欀猀∀ऀ∀䌀꜀渞 琀爀케∞ऀ嬀␀堀㌀㘀　崀ഀഀ
"[english]GameUI_JoystickMoveLookSticks"	"Thumbsticks"਍∀䜀愀洀攀唀䤀开䨀漀礀猀琀椀挀欀匀漀甀琀栀瀀愀眀∀ऀ∀䠀漀渀 ᄀ픁椞 挀 琀爀渀 琀愀礀 挀꜀洞 瘀椞 栀愀椀 挀∀ऀ嬀␀圀䤀一㌀㈀崀ഀഀ
"[english]GameUI_JoystickSouthpaw"	"Swap sticks on dual-stick controllers"਍∀䜀愀洀攀唀䤀开䨀漀礀猀琀椀挀欀匀漀甀琀栀瀀愀眀∀ऀ∀匀漀甀琀栀瀀愀眀∀ऀ嬀␀堀㌀㘀　崀ഀഀ
"[english]GameUI_JoystickSouthpaw"	"Southpaw"਍∀䜀愀洀攀唀䤀开䨀漀礀猀琀椀挀欀䰀漀漀欀匀瀀攀攀搀倀椀琀挀栀∀ऀ∀က„渀栀ꄀ礞 挀栀椀섀甞 搀촀挞∀ഀഀ
"[english]GameUI_JoystickLookSpeedPitch"	"Vertical sensitivity"਍∀䜀愀洀攀唀䤀开䨀漀礀猀琀椀挀欀䰀漀漀欀匀瀀攀攀搀夀愀眀∀ऀ∀က„渀栀ꄀ礞 挀栀椀섀甞 渀最愀渀最∀ഀഀ
"[english]GameUI_JoystickLookSpeedYaw"	"Horizontal sensitivity"਍∀䜀愀洀攀唀䤀开䨀漀礀猀琀椀挀欀䐀甀挀欀娀漀漀洀䴀漀搀攀∀ऀ∀䌀栀뼀„ᄀ„一最팀椞 砀픀洞 ⼀ 吀栀甀 瀀栀渀最∀ഀഀ
"[english]GameUI_JoystickDuckZoomMode"	"Duck/Zoom mode"਍∀䜀愀洀攀唀䤀开䨀漀礀猀琀椀挀欀䐀甀挀欀䴀漀搀攀∀ऀ∀䌀栀뼀„ᄀ„渀最팀椞∀ഀഀ
"[english]GameUI_JoystickDuckMode"	"Duck mode"਍∀䜀愀洀攀唀䤀开䨀漀礀猀琀椀挀欀匀瀀爀椀渀琀䴀漀搀攀∀ऀ∀䌀栀ꄀ礞 琀栀攀漀∀ഀഀ
"[english]GameUI_JoystickSprintMode"	"Sticky Sprint"਍∀䜀愀洀攀唀䤀开䄀甀琀漀䄀椀洀∀ऀ∀吀„ᄀ渞最 渀最꼀洞∀ഀഀ
"[english]GameUI_AutoAim"	"Auto-Aim"਍∀䜀愀洀攀唀䤀开䄀甀琀漀愀椀洀䰀愀戀攀氀∀ऀ∀吀„ᄀ渞最 渀最꼀洞 瘀漀 欀묀„琀栀豈⸀∀ഀഀ
"[english]GameUI_AutoaimLabel"	"Aims at enemies automatically."਍∀䜀愀洀攀唀䤀开䌀漀渀琀攀渀琀䰀漀挀欀∀ऀ∀䬀栀愀 渀椞 搀甀渀最∀ഀഀ
"[english]GameUI_ContentLock"	"Content lock"਍∀䜀愀洀攀唀䤀开䌀漀渀琀攀渀琀䰀漀挀欀䰀愀戀攀氀∀ऀ∀一栀ꔀ渞 瘀漀 渀切琀 渀礀 瘀 渀栀관瀞 洀관琞 欀栀ꌀ甞 ᄀ쌁„琀꼀琞尀渀渀栀渞最 栀渀栀 ꌀ渞栀 欀栀渀最 瀀栀豈 栀瀞 挀栀漀 渀最뀀?椞 挀栀ꄀ椁 琀爀묀„琀甀픀椞⸀∀ഀഀ
"[english]GameUI_ContentLockLabel"	"Press this button and enter password to disable\nvisuals inappropriate for younger players."਍∀䜀愀洀攀唀䤀开䌀漀渀琀攀渀琀匀琀愀琀甀猀䐀椀猀愀戀氀攀搀∀ऀ∀一栀관瀞 洀관琞 欀栀꤀甞 ᄀ쌁„戀관琞 欀栀愀 渀椀 搀甀渀最⸀∀ഀഀ
"[english]GameUI_ContentStatusDisabled"	"Enter a password to enable the content lock."਍∀䜀愀洀攀唀䤀开䌀漀渀琀攀渀琀匀琀愀琀甀猀䔀渀愀戀氀攀搀∀ऀ∀一栀관瀞 洀관琞 欀栀꤀甞 ᄀ쌁„琀꼀琞 欀栀愀 渀椀 搀甀渀最⸀∀ഀഀ
"[english]GameUI_ContentStatusEnabled"	"Enter a password to disable the content lock."਍∀䜀愀洀攀唀䤀开䔀渀愀戀氀攀∀ऀ∀䈀관琞∀ഀഀ
"[english]GameUI_Enable"	"Enable"਍∀䜀愀洀攀唀䤀开䐀椀猀愀戀氀攀∀ऀ∀吀꼀琞∀ഀഀ
"[english]GameUI_Disable"	"Disable"਍∀䜀愀洀攀唀䤀开倀愀猀猀眀漀爀搀倀爀漀洀瀀琀∀ऀ∀嘀甀椀 氀渀最 渀栀관瀞 洀琞 洀관琞 欀栀꤀甞∀ഀഀ
"[english]GameUI_PasswordPrompt"	"Please enter a password"਍∀䜀愀洀攀唀䤀开倀愀猀猀眀漀爀搀䐀椀猀愀戀氀攀倀爀漀洀瀀琀∀ऀ∀嘀甀椀 氀渀最 渀栀관瀞 洀관琞 欀栀꤀甞∀ഀഀ
"[english]GameUI_PasswordDisablePrompt"	"Please enter password"਍∀䜀愀洀攀唀䤀开倀愀猀猀眀漀爀搀刀攀攀渀琀爀礀倀爀漀洀瀀琀∀ऀ∀一栀관瀞 氀ꄀ椞 洀관琞 欀栀꤀甞∀ഀഀ
"[english]GameUI_PasswordReentryPrompt"	"Re-enter a password"਍∀䜀愀洀攀唀䤀开䌀愀渀挀攀氀∀ऀ∀䠀礞∀ഀഀ
"[english]GameUI_Cancel"	"Cancel"਍∀䜀愀洀攀唀䤀开䈀愀挀欀∀ऀ∀吀爀?„氀ꄀ椞∀ഀഀ
"[english]GameUI_Back"	"Back"਍∀䜀愀洀攀唀䤀开䄀瀀瀀氀礀∀ऀ∀섀瀀 搀渞最∀ഀഀ
"[english]GameUI_Apply"	"Apply"਍∀䜀愀洀攀唀䤀开䐀攀洀漀倀氀愀礀攀爀∀ऀ∀吀爀渀栀 瀀栀琀 搀攀洀漀∀ഀഀ
"[english]GameUI_DemoPlayer"	"Demo Player"਍∀䜀愀洀攀唀䤀开䰀漀愀搀䐀攀洀漀∀ऀ∀䌀栀촀渞 琀윀瀞 琀栀„渀最栀椀윀洞∀ഀഀ
"[english]GameUI_LoadDemo"	"Choose Demo File"਍∀䜀愀洀攀唀䤀开䰀漀愀搀∀ऀ∀吀ꌀ椞∀ഀഀ
"[english]GameUI_Load"	"Load"਍∀䜀愀洀攀唀䤀开䐀攀洀漀䘀椀氀攀∀ऀ∀吀윀瀞 琀栀„渀最栀椀윀洞∀ഀഀ
"[english]GameUI_DemoFile"	"Demo File"਍∀䜀愀洀攀唀䤀开䴀愀瀀∀ऀ∀䈀ꌀ渞 ᄀ팁∞ഀഀ
"[english]GameUI_Map"	"Map"਍∀䜀愀洀攀唀䤀开䌀氀漀猀攀∀ऀ∀က渀最∀ഀഀ
"[english]GameUI_Close"	"Close"਍∀䜀愀洀攀唀䤀开一攀瘀攀爀匀栀漀眀䈀甀琀琀漀渀∀ऀ∀䬀栀渀最 栀椀쌀渞 琀栀쬀„氀ꄀ椞 栀瀞 琀栀漀ꄀ椞 渀礀∀ഀഀ
"[english]GameUI_NeverShowButton"	"Do not show this dialog again"਍∀䜀愀洀攀唀䤀开䈀漀渀甀猀䴀愀瀀猀䠀攀氀瀀∀ऀ∀䌀栀촀渞 戀ꌀ渞 ᄀ팁„琀栀洀 栀漀뜀挞 琀栀뀀 洀挞 戀渀 搀뀀椞Ⰰ 猀愀甀 ᄀ 渀栀ꔀ渞 尀∀一ꄀ瀞尀∀∀ഀഀ
"[english]GameUI_BonusMapsHelp"	"Select a bonus map or folder below, then click 'Load'"਍∀䜀愀洀攀唀䤀开䈀漀渀甀猀䴀愀瀀猀∀ऀ∀䈀ꈀ丞 က툁„吀䠀쨀䴀∀ഀഀ
"[english]GameUI_BonusMaps"	"BONUS MAPS"਍∀䜀愀洀攀唀䤀开䈀漀渀甀猀䴀愀瀀猀䌀漀洀瀀氀攀琀椀漀渀∀ऀ∀䠀漀渀 琀栀渀栀∀ഀഀ
"[english]GameUI_BonusMapsCompletion"	"Complete"਍∀䜀愀洀攀唀䤀开䈀漀渀甀猀䴀愀瀀猀唀渀氀漀挀欀攀搀∀ऀ∀⬀吀栀洀∀ഀഀ
"[english]GameUI_BonusMapsUnlocked"	"+Bonus"਍∀䜀愀洀攀唀䤀开䈀漀渀甀猀䴀愀瀀猀匀琀愀渀搀愀爀搀∀ऀ∀吀椀甀 挀栀甀꤀渞∀ഀഀ
"[english]GameUI_BonusMapsStandard"	"Standard"਍∀䜀愀洀攀唀䤀开䈀漀渀甀猀䴀愀瀀猀䄀搀瘀愀渀挀攀搀∀ऀ∀一渀最 挀愀漀∀ഀഀ
"[english]GameUI_BonusMapsAdvanced"	"Advanced"਍∀䜀愀洀攀唀䤀开䈀漀渀甀猀䴀愀瀀猀䈀攀猀琀∀ऀ∀䬀„氀挞㨀 ─猀㄀∀ഀഀ
"[english]GameUI_BonusMapsBest"	"Best: %s1"਍∀䜀愀洀攀唀䤀开䈀漀渀甀猀䴀愀瀀猀䜀漀愀氀∀ऀ∀䴀挞 琀椀甀㨀 ─猀㄀∀ഀഀ
"[english]GameUI_BonusMapsGoal"	"Goal: %s1"਍∀䜀愀洀攀唀䤀开䰀漀愀搀䜀愀洀攀䠀攀氀瀀∀ऀ∀䌀栀촀渞 洀琞 戀ꌀ渞 氀뀀甁 琀爀漀渀最 搀愀渀栀 猀挀栀 搀뀀椞Ⰰ 猀愀甀 ᄀ 渀栀ꔀ瀞 ✀一ꄀ瀞 琀爀 挀栀ꄀ椁✀⸀∀ഀഀ
"[english]GameUI_LoadGameHelp"	"Select a saved game in the list below, then click 'Load game'."਍∀䜀愀洀攀唀䤀开䰀漀愀搀䜀愀洀攀∀ऀ∀一ꀀ倞 吀刀툀 䌀䠀ꀀ䤁∀ഀഀ
"[english]GameUI_LoadGame"	"LOAD GAME"਍∀䜀愀洀攀唀䤀开䴀甀氀琀椀瀀氀愀礀攀爀䄀搀瘀愀渀挀攀搀∀ऀ∀䌀䠀ꀀ䤁 一䠀䤀쀀唞 一䜀꼀?䤞 一숀一䜀 䌀䄀伀∀ഀഀ
"[english]GameUI_MultiplayerAdvanced"	"MULTIPLAYER ADVANCED"਍∀䜀愀洀攀唀䤀开䴀甀氀琀椀瀀氀愀礀攀爀䌀甀猀琀漀洀椀稀攀∀ऀ∀吀甀„挀栀준渞栀 挀栀ꄀ椁 渀栀椀섀甞 渀最뀀?椞∀ഀഀ
"[english]GameUI_MultiplayerCustomize"	"Multiplayer Customize"਍∀䜀愀洀攀唀䤀开䴀甀氀琀椀瀀氀愀礀攀爀∀ऀ∀䌀栀ꄀ椁 渀栀椀섀甞 渀最뀀?椞∀ഀഀ
"[english]GameUI_Multiplayer"	"Multiplayer"਍∀䜀愀洀攀唀䤀开伀䬀∀ऀ∀伀䬀∀ഀഀ
"[english]GameUI_OK"	"OK"਍∀䜀愀洀攀唀䤀开䄀搀瘀愀渀挀攀搀䔀氀氀椀瀀猀椀猀∀ऀ∀一渀最 挀愀漀⸀⸀⸀∀ഀഀ
"[english]GameUI_AdvancedEllipsis"	"Advanced..."਍∀䜀愀洀攀唀䤀开䄀搀瘀愀渀挀攀搀一漀䔀氀氀椀瀀猀椀猀∀ऀ∀一渀最 挀愀漀∀ഀഀ
"[english]GameUI_AdvancedNoEllipsis"	"Advanced"਍∀䜀愀洀攀唀䤀开倀氀愀礀攀爀一愀洀攀∀ऀ∀吀渀 渀最뀀?椞 挀栀ꄀ椁∀ഀഀ
"[english]GameUI_PlayerName"	"Player name"਍∀䜀愀洀攀唀䤀开倀爀椀洀愀爀礀䌀漀氀漀爀∀ऀ∀䴀甀 挀栀„ᄀꄁ漞∀ഀഀ
"[english]GameUI_PrimaryColor"	"Primary color"਍∀䜀愀洀攀唀䤀开匀攀挀漀渀搀愀爀礀䌀漀氀漀爀∀ऀ∀䴀甀 瀀栀∞ഀഀ
"[english]GameUI_SecondaryColor"	"Secondary color"਍∀䜀愀洀攀唀䤀开䠀椀最栀䴀漀搀攀氀猀∀ऀ∀匀„搀渞最 洀 栀渀栀 挀栀ꔀ琞 氀뀀渞最 挀愀漀∀ഀഀ
"[english]GameUI_HighModels"	"Use high quality models"਍∀䜀愀洀攀唀䤀开倀氀愀礀攀爀䴀漀搀攀氀∀ऀ∀䴀 栀渀栀 渀最뀀?椞 挀栀ꄀ椁∀ഀഀ
"[english]GameUI_PlayerModel"	"Player model"਍∀䜀愀洀攀唀䤀开匀瀀爀愀礀瀀愀椀渀琀䤀洀愀最攀∀ऀ∀䠀渀栀 ꌀ渞栀 瀀栀甀渀 猀ꄀ渁∀ഀഀ
"[english]GameUI_SpraypaintImage"	"Spraypaint image"਍∀䜀愀洀攀唀䤀开匀瀀爀愀礀瀀愀椀渀琀匀攀爀瘀攀爀一漀琀攀∀ऀ∀一栀渞最 琀栀愀礀 ᄀ픁椞 瘀섀„栀渀栀 瀀栀甀渀 猀ꄀ渁 挀愞 戀ꄀ渞 猀봀„ᄀ뀁挞 瀀 搀渞最 欀栀椀 戀ꄀ渞 琀栀愀洀 最椀愀 洀琞 洀礀 挀栀⸞∀ഀഀ
"[english]GameUI_SpraypaintServerNote"	"Changes to your spraypaint image take effect when you join a server."਍∀䜀愀洀攀唀䤀开一攀眀䜀愀洀攀∀ऀ∀䌀䠀ꀀ䤁 䴀䤞∀ഀഀ
"[english]GameUI_NewGame"	"NEW GAME"਍∀䜀愀洀攀唀䤀开一攀眀䜀愀洀攀䠀攀氀瀀吀攀砀琀∀ऀ∀䌀栀촀渞 ᄀ„欀栀 挀愞 倀栀渀最 琀관瀞尀渀爀팀椞 渀栀ꔀ渞 ᠀䌠栀ꄀ椁ᤀ⸠∀ഀഀ
"[english]GameUI_NewGameHelpText"	"Select a level of difficulty or the Training\nroom, then click 'Play'."਍∀䜀愀洀攀唀䤀开吀爀愀椀渀椀渀最刀漀漀洀∀ऀ∀倀䠀툀一䜀 吀가倞∀ഀഀ
"[english]GameUI_TrainingRoom"	"TRAINING ROOM"਍∀䜀愀洀攀唀䤀开䔀愀猀礀∀ऀ∀䐀씀∞ഀഀ
"[english]GameUI_Easy"	"Easy"਍∀䜀愀洀攀唀䤀开䴀攀搀椀甀洀∀ऀ∀吀栀뀀?渞最∀ഀഀ
"[english]GameUI_Medium"	"Medium"਍∀䜀愀洀攀唀䤀开䠀愀爀搀∀ऀ∀䬀栀∀ഀഀ
"[english]GameUI_Hard"	"Hard"਍∀䜀愀洀攀唀䤀开匀攀氀攀挀琀匀欀椀氀氀∀ऀ∀䌀䠀찀丞 က„䬀䠀팀 䌀䠀䤀븀丞 吀刀꼀?丞䜀∀ഀഀ
"[english]GameUI_SelectSkill"	"SELECT COMBAT DIFFICULTY"਍∀䜀愀洀攀唀䤀开匀琀愀爀琀一攀眀䜀愀洀攀∀ऀ∀䈀꼀琞 ᄀ꜁甞 琀爀 挀栀ꄀ椁 洀椞∀ഀഀ
"[english]GameUI_StartNewGame"	"Start new game"਍∀䜀愀洀攀唀䤀开一攀砀琀∀ऀ∀吀栀洀 㸀∀ഀഀ
"[english]GameUI_Next"	"More >"਍∀䜀愀洀攀唀䤀开倀爀攀瘀∀ऀ∀㰀 吀栀洀∀ഀഀ
"[english]GameUI_Prev"	"< More"਍∀䜀愀洀攀唀䤀开倀氀愀礀∀ऀ∀䌀栀ꄀ椁∀ഀഀ
"[english]GameUI_Play"	"Play"਍∀䜀愀洀攀唀䤀开䔀渀愀戀氀攀䔀䄀堀∀ऀ∀䬀挀栀 栀漀ꄀ琞 栀휀„琀爀„瀀栀꜀渞 挀渞最 䔀䄀堀∀ഀഀ
"[english]GameUI_EnableEAX"	"Enable EAX Hardware Support"਍∀䜀愀洀攀唀䤀开䔀渀愀戀氀攀䄀㌀䐀∀ऀ∀䬀挀栀 栀漀ꄀ琞 栀휀„琀爀„瀀栀꜀渞 挀渞最 䄀㌀䐀∀ഀഀ
"[english]GameUI_EnableA3D"	"Enable A3D Hardware Support"਍∀䜀愀洀攀唀䤀开匀漀甀渀搀䔀昀昀攀挀琀嘀漀氀甀洀攀∀ऀ∀숀洀 氀뀀渞最 琀爀 挀栀ꄀ椁∀ഀഀ
"[english]GameUI_SoundEffectVolume"	"Game volume"਍∀䜀愀洀攀唀䤀开䠀䔀嘀匀甀椀琀嘀漀氀甀洀攀∀ऀ∀숀洀 氀뀀渞最 戀„䠀䔀嘀∀ഀഀ
"[english]GameUI_HEVSuitVolume"	"HEV suit volume"਍∀䜀愀洀攀唀䤀开䴀倀㌀嘀漀氀甀洀攀∀ऀ∀숀洀 氀뀀渞最 䴀倀㌀ ⨀∀ഀഀ
"[english]GameUI_MP3Volume"	"MP3 volume *"਍∀䜀愀洀攀唀䤀开䴀甀猀椀挀嘀漀氀甀洀攀∀ऀ∀숀洀 氀뀀渞最 挀栀漀 渀栀ꄀ挞∀ഀഀ
"[english]GameUI_MusicVolume"	"Music volume"਍∀䜀愀洀攀唀䤀开匀漀甀渀搀儀甀愀氀椀琀礀∀ऀ∀䌀栀ꔀ琞 氀뀀渞最 洀 琀栀愀渀栀∀ഀഀ
"[english]GameUI_SoundQuality"	"Sound quality"਍∀䜀愀洀攀唀䤀开唀氀琀爀愀∀ऀ∀刀ꔀ琞 挀愀漀∀ഀഀ
"[english]GameUI_Ultra"	"Very High"਍∀䜀愀洀攀唀䤀开䠀椀最栀∀ऀ∀䌀愀漀∀ഀഀ
"[english]GameUI_High"	"High"਍∀䜀愀洀攀唀䤀开䰀漀眀∀ऀ∀吀栀ꔀ瀞∀ഀഀ
"[english]GameUI_Low"	"Low"਍∀䜀愀洀攀唀䤀开唀猀攀䐀攀昀愀甀氀琀猀∀ऀ∀䐀豈渀最 洀뜀挞 ᄀ쬁渞栀∀ഀഀ
"[english]GameUI_UseDefaults"	"Use Defaults"਍∀䜀愀洀攀唀䤀开匀攀琀一攀眀䬀攀礀∀ऀ∀䌀栀준渞栀 猀愞 瀀栀洀∀ഀഀ
"[english]GameUI_SetNewKey"	"Edit key"਍∀䜀愀洀攀唀䤀开䌀氀攀愀爀䬀攀礀∀ऀ∀䈀케„瀀栀洀∀ഀഀ
"[english]GameUI_ClearKey"	"Clear Key"਍∀䜀愀洀攀唀䤀开匀攀琀一攀眀䈀甀琀琀漀渀∀ऀ∀一栀ꔀ渞 洀琞 渀切琀⸀⸀⸀∀ഀഀ
"[english]GameUI_SetNewButton"	"Press a button..."਍∀䜀愀洀攀唀䤀开䌀氀攀愀爀䈀甀琀琀漀渀∀ऀ∀堀愀∀ഀഀ
"[english]GameUI_ClearButton"	"Clear"਍∀䜀愀洀攀唀䤀开䐀攀昀愀甀氀琀䈀甀琀琀漀渀猀∀ऀ∀က椁섀甞 欀栀椀쌀渞 洀뜀挞 ᄀ쬁渞栀∀ഀഀ
"[english]GameUI_DefaultButtons"	"Default controls"਍∀䜀愀洀攀唀䤀开䄀挀琀椀漀渀∀ऀ∀䠀渀栀 ᄀ渞最∀ഀഀ
"[english]GameUI_Action"	"Action"਍∀䜀愀洀攀唀䤀开吀漀最最氀攀∀ऀ∀䈀관琞 琀꼀琞∀ഀഀ
"[english]GameUI_Toggle"	"Toggle"਍∀䜀愀洀攀唀䤀开䠀漀氀搀∀ऀ∀䜀椀∞ഀഀ
"[english]GameUI_Hold"	"Hold"਍∀䜀愀洀攀唀䤀开䬀攀礀䈀甀琀琀漀渀∀ऀ∀倀䠀촀䴀⼀一吀∀ഀഀ
"[english]GameUI_KeyButton"	"KEY/BUTTON"਍∀䜀愀洀攀唀䤀开䄀氀琀攀爀渀愀琀攀∀ऀ∀䬀䠀섀䌀∀ഀഀ
"[english]GameUI_Alternate"	"ALTERNATE"਍∀䜀愀洀攀唀䤀开圀椀渀搀漀眀攀搀∀ऀ∀嘀漀 琀爀漀渀最 挀愞 猀픀∞ഀഀ
"[english]GameUI_Windowed"	"Run in a window"਍∀䜀愀洀攀唀䤀开匀漀昀琀眀愀爀攀∀ऀ∀倀栀꜀渞 洀섀洞∀ഀഀ
"[english]GameUI_Software"	"Software"਍∀䜀愀洀攀唀䤀开伀瀀攀渀䜀䰀∀ऀ∀伀瀀攀渀䜀䰀∀ഀഀ
"[english]GameUI_OpenGL"	"OpenGL"਍∀䜀愀洀攀唀䤀开䐀㌀䐀∀ऀ∀䐀㌀䐀∀ഀഀ
"[english]GameUI_D3D"	"D3D"਍∀䜀愀洀攀唀䤀开䈀爀椀最栀琀渀攀猀猀∀ऀ∀က„猀渀最∀ഀഀ
"[english]GameUI_Brightness"	"Brightness"਍∀䜀愀洀攀唀䤀开䜀愀洀洀愀∀ऀ∀䜀愀洀洀愀∀ഀഀ
"[english]GameUI_Gamma"	"Gamma"਍∀䜀愀洀攀唀䤀开刀攀猀漀氀甀琀椀漀渀∀ऀ∀က„瀀栀渀 最椀ꌀ椞∀ഀഀ
"[english]GameUI_Resolution"	"Resolution"਍∀䜀愀洀攀唀䤀开嘀椀搀攀漀刀攀猀琀愀爀琀∀ऀ∀䰀뀀甁 ﴀ㨀 琀栀愀礀 ᄀ픁椞 琀豈礀 挀栀촀渞 瘀椀搀攀漀 猀봀„欀栀椀뼀渞 琀爀 挀栀ꄀ椁 琀栀漀琀 爀愀 瘀 欀栀?椞 ᄀ渞最 氀ꄀ椞⸀∀ഀഀ
"[english]GameUI_VideoRestart"	"Note: changing video options will cause the game to exit and restart."਍∀䜀愀洀攀唀䤀开䔀渀愀戀氀攀嘀漀椀挀攀∀ऀ∀䈀관琞 最椀촀渞最 渀椀 琀爀漀渀最 琀爀 挀栀ꄀ椁 渀礀∀ഀഀ
"[english]GameUI_EnableVoice"	"Enable voice in this game"਍∀䜀愀洀攀唀䤀开䈀漀漀猀琀䴀椀挀爀漀瀀栀漀渀攀∀ऀ∀吀̀渁最 洀 琀栀愀渀栀 洀椀挀爀∀ഀഀ
"[english]GameUI_BoostMicrophone"	"Boost microphone gain"਍∀䜀愀洀攀唀䤀开䴀椀挀爀漀瀀栀漀渀攀嘀漀氀甀洀攀∀ऀ∀숀洀 氀뀀渞最 洀椀挀爀∀ഀഀ
"[english]GameUI_MicrophoneVolume"	"Microphone Volume"਍∀䜀愀洀攀唀䤀开刀攀挀攀椀瘀攀嘀漀氀甀洀攀∀ऀ∀숀洀 氀뀀渞最 渀栀관渞 ᄀ뀁挞∀ഀഀ
"[english]GameUI_ReceiveVolume"	"Receive Volume"਍∀䜀愀洀攀唀䤀开吀攀猀琀䴀椀挀爀漀瀀栀漀渀攀∀ऀ∀䬀椀쌀洞 琀爀愀 洀椀挀爀∀ഀഀ
"[english]GameUI_TestMicrophone"	"Test Microphone"਍∀䜀愀洀攀唀䤀开匀琀漀瀀吀攀猀琀䴀椀挀爀漀瀀栀漀渀攀∀ऀ∀䐀渞最 欀椀쌀洞 琀爀愀 洀椀挀爀∀ഀഀ
"[english]GameUI_StopTestMicrophone"	"Stop Microphone Test"਍∀䜀愀洀攀唀䤀开嘀漀椀挀攀刀攀挀攀椀瘀攀嘀漀氀甀洀攀∀ऀ∀숀洀 氀뀀渞最 最椀촀渞最 渀椀 渀栀관渞 ᄀ뀁挞 ⨀∀ഀഀ
"[english]GameUI_VoiceReceiveVolume"	"Voice receive volume *"਍∀䜀愀洀攀唀䤀开嘀漀椀挀攀吀爀愀渀猀洀椀琀嘀漀氀甀洀攀∀ऀ∀숀洀 氀뀀渞最 最椀촀渞最 渀椀 琀爀甀礀섀渞 瀀栀琀 ⨀∀ഀഀ
"[english]GameUI_VoiceTransmitVolume"	"Voice transmit volume *"਍∀䜀愀洀攀唀䤀开匀愀瘀攀䜀愀洀攀∀ऀ∀䰀꼀唁 吀刀툀 䌀䠀ꀀ䤁∀ഀഀ
"[english]GameUI_SaveGame"	"SAVE GAME"਍∀䜀愀洀攀唀䤀开匀愀瘀攀䜀愀洀攀䠀攀氀瀀∀ऀ∀䌀栀촀渞 ✀䈀ꌀ渞 挀栀ꄀ椁 洀椞✀ 琀爀漀渀最 搀愀渀栀 猀挀栀 ᄀ쌁„琀ꄀ漞 琀윀瀞 洀椞Ⰰ 栀漀뜀挞 挀栀촀渞尀渀洀琞 戀ꌀ渞 氀뀀甁 琀爀뀀挞 ᄀ ᄀ쌁„瘀椀뼀琞 ᄀ섁„氀渀 琀윀瀞⸀∀ഀഀ
"[english]GameUI_SaveGameHelp"	"Select 'New Save Game' in the list to create a new file, or select\na previously saved game to overwrite a file."਍∀䜀愀洀攀唀䤀开䐀攀氀攀琀攀∀ऀ∀堀愀∀ഀഀ
"[english]GameUI_Delete"	"Delete"਍∀䜀愀洀攀唀䤀开儀甀椀琀∀ऀ∀吀栀漀琀 琀爀 挀栀ꄀ椁∀ഀഀ
"[english]GameUI_Quit"	"Quit game"਍∀䜀愀洀攀唀䤀开匀琀攀愀洀倀愀猀猀眀漀爀搀∀ऀ∀䴀관琞 欀栀꤀甞 匀琀攀愀洀∀ഀഀ
"[english]GameUI_SteamPassword"	"Steam Password"਍∀䜀愀洀攀唀䤀开䌀爀攀愀琀攀匀攀爀瘀攀爀∀ऀ∀吀ꀀ伞 䴀섀夀 䌀䠀∞ഀഀ
"[english]GameUI_CreateServer"	"CREATE SERVER"਍∀䜀愀洀攀唀䤀开匀琀愀爀琀∀ऀ∀䈀꼀琞 ᄀ꜁甞∀ഀഀ
"[english]GameUI_Start"	"Start"਍∀䜀愀洀攀唀䤀开䌀漀渀猀漀氀攀∀ऀ∀䌀漀渀猀漀氀攀∀ഀഀ
"[english]GameUI_Console"	"Console"਍∀䜀愀洀攀唀䤀开匀甀戀洀椀琀∀ऀ∀䜀椞∀ഀഀ
"[english]GameUI_Submit"	"Submit"਍∀䜀愀洀攀唀䤀开伀瀀琀椀漀渀猀∀ऀ∀吀唀„䌀䠀찀丞∀ഀഀ
"[english]GameUI_Options"	"OPTIONS"਍∀䜀愀洀攀唀䤀开䬀攀礀戀漀愀爀搀∀ऀ∀䈀渀 瀀栀洀∀ഀഀ
"[english]GameUI_Keyboard"	"Keyboard"਍∀䜀愀洀攀唀䤀开䴀漀甀猀攀∀ऀ∀䌀栀甀琞∀ഀഀ
"[english]GameUI_Mouse"	"Mouse"਍∀䜀愀洀攀唀䤀开䄀甀搀椀漀∀ऀ∀숀洀 琀栀愀渀栀∀ഀഀ
"[english]GameUI_Audio"	"Audio"਍∀䜀愀洀攀唀䤀开嘀椀搀攀漀∀ऀ∀嘀椀搀攀漀∀ഀഀ
"[english]GameUI_Video"	"Video"਍∀䜀愀洀攀唀䤀开嘀漀椀挀攀∀ऀ∀က洀 琀栀漀ꄀ椞∀ഀഀ
"[english]GameUI_Voice"	"Voice"਍∀䜀愀洀攀唀䤀开䄀搀瘀愀渀挀攀搀∀ऀ∀䬀栀愀∀ഀഀ
"[english]GameUI_Advanced"	"Lock"਍∀䜀愀洀攀唀䤀开匀攀爀瘀攀爀∀ऀ∀䴀礀 挀栀∞ഀഀ
"[english]GameUI_Server"	"Server"਍∀䜀愀洀攀唀䤀开䜀愀洀攀∀ऀ∀吀爀 挀栀ꄀ椁∀ऀ嬀␀圀䤀一㌀㈀崀ഀഀ
"[english]GameUI_Game"	"Game"਍∀䜀愀洀攀唀䤀开匀愀瘀攀搀䜀愀洀攀∀ऀ∀䈀ꌀ渞 氀뀀甁∀ഀഀ
"[english]GameUI_SavedGame"	"Saved Game"਍∀䜀愀洀攀唀䤀开䔀氀愀瀀猀攀搀吀椀洀攀∀ऀ∀吀栀?椞 最椀愀渀 ᄀ 焀甀愀∀ഀഀ
"[english]GameUI_ElapsedTime"	"Elapsed Time"਍∀䜀愀洀攀唀䤀开吀椀洀攀匀琀愀洀瀀∀ऀ∀䴀턀挞 琀栀?椞 最椀愀渀∀ഀഀ
"[english]GameUI_TimeStamp"	"Time Stamp"਍∀䜀愀洀攀唀䤀开䬀攀礀戀漀愀爀搀匀攀琀琀椀渀最猀∀ऀ∀吀栀椀뼀琞 氀관瀞 戀渀 瀀栀洀∀ഀഀ
"[english]GameUI_KeyboardSettings"	"Keyboard settings"਍∀䜀愀洀攀唀䤀开䬀攀礀戀漀愀爀搀匀攀琀琀椀渀最猀吀攀砀琀∀ऀ∀က뜁琞 氀ꄀ椞 洀촀椞 栀渀栀 ᄀ渞最 ᄀ쌁„搀豈渀最 瀀栀洀 洀뜀挞 ᄀ쬁渞栀㼀∀ഀഀ
"[english]GameUI_KeyboardSettingsText"	"Reset all actions to use their default keys?"਍∀䜀愀洀攀唀䤀开䌀漀渀琀爀漀氀氀攀爀匀攀琀琀椀渀最猀吀攀砀琀∀ऀ∀က뜁琞 琀漀渀 戀„琀栀椀뼀琞 氀관瀞 琀愀礀 挀꜀洞 瘀섀„洀뜀挞 ᄀ쬁渞栀㼀∀ഀഀ
"[english]GameUI_ControllerSettingsText"	"Reset all controller options to their defaults?"਍∀䜀愀洀攀唀䤀开䜀愀洀攀䴀攀渀甀开一攀眀䜀愀洀攀∀ऀ∀吀刀툀 䌀䠀ꀀ䤁 䴀䤞∀ഀഀ
"[english]GameUI_GameMenu_NewGame"	"NEW GAME"਍∀䜀愀洀攀唀䤀开䜀愀洀攀䴀攀渀甀开倀氀愀礀䐀攀洀漀∀ऀ∀䌀䠀ꀀ䤁 吀䠀∞ഀഀ
"[english]GameUI_GameMenu_PlayDemo"	"PLAY DEMO"਍∀䜀愀洀攀唀䤀开䜀愀洀攀䴀攀渀甀开䈀漀渀甀猀䴀愀瀀猀∀ऀ∀䈀ꈀ丞 က툁„吀䠀쨀䴀∀ഀഀ
"[english]GameUI_GameMenu_BonusMaps"	"BONUS MAPS"਍∀䜀愀洀攀唀䤀开䜀愀洀攀䴀攀渀甀开䰀漀愀搀䜀愀洀攀∀ऀ∀一ꀀ倞 吀刀툀 䌀䠀ꀀ䤁∀ഀഀ
"[english]GameUI_GameMenu_LoadGame"	"LOAD GAME"਍∀䜀愀洀攀唀䤀开䜀愀洀攀䴀攀渀甀开匀愀瘀攀䜀愀洀攀∀ऀ∀䰀꼀唁 吀刀툀 䌀䠀ꀀ䤁∀ഀഀ
"[english]GameUI_GameMenu_SaveGame"	"SAVE GAME"਍∀䜀愀洀攀唀䤀开䜀愀洀攀䴀攀渀甀开䴀甀氀琀椀瀀氀愀礀攀爀∀ऀ∀䌀䠀ꀀ䤁 一䠀䤀쀀唞 一䜀꼀?䤞∀ഀഀ
"[english]GameUI_GameMenu_Multiplayer"	"MULTIPLAYER "਍∀䜀愀洀攀唀䤀开䜀愀洀攀䴀攀渀甀开䘀椀渀搀匀攀爀瘀攀爀猀∀ऀ∀吀찀䴀 䴀섀夀 䌀䠀∞ഀഀ
"[english]GameUI_GameMenu_FindServers"	"FIND SERVERS"਍∀䜀愀洀攀唀䤀开䜀愀洀攀䴀攀渀甀开䘀爀椀攀渀搀猀∀ऀ∀䈀ꀀ丞 䈀저∀ഀഀ
"[english]GameUI_GameMenu_Friends"	"FRIENDS"਍∀䜀愀洀攀唀䤀开䜀愀洀攀䴀攀渀甀开䌀甀猀琀漀洀椀稀攀∀ऀ∀吀唀„䌀䠀저丞䠀∀ഀഀ
"[english]GameUI_GameMenu_Customize"	"CUSTOMIZE"਍∀䜀愀洀攀唀䤀开䜀愀洀攀䴀攀渀甀开䌀爀攀愀琀攀匀攀爀瘀攀爀∀ऀ∀吀ꀀ伞 䴀섀夀 䌀䠀∞ഀഀ
"[english]GameUI_GameMenu_CreateServer"	"CREATE SERVER"਍∀䜀愀洀攀唀䤀开䜀愀洀攀䴀攀渀甀开伀瀀琀椀漀渀猀∀ऀ∀吀夀 䌀䠀찀丞∀ഀഀ
"[english]GameUI_GameMenu_Options"	"OPTIONS"਍∀䜀愀洀攀唀䤀开䜀愀洀攀䴀攀渀甀开䄀挀栀椀攀瘀攀洀攀渀琀猀∀ऀ∀吀䠀쀀一䠀 吀唞∀ഀഀ
"[english]GameUI_GameMenu_Achievements"	"ACHIEVEMENTS"਍∀䜀愀洀攀唀䤀开䜀愀洀攀䴀攀渀甀开倀氀愀礀攀爀匀琀愀琀猀∀ऀ∀吀䠀퐀一䜀 吀䤀一 一䜀꼀?䤞 䌀䠀ꀀ䤁∀ഀഀ
"[english]GameUI_GameMenu_PlayerStats"	"PLAYER STATS"਍∀䜀愀洀攀唀䤀开䜀愀洀攀䴀攀渀甀开儀甀椀琀∀ऀ∀吀䠀伀섀吀∀ഀഀ
"[english]GameUI_GameMenu_Quit"	"QUIT"਍∀䜀愀洀攀唀䤀开倀愀猀猀眀漀爀搀猀䐀漀渀琀䴀愀琀挀栀∀ऀ∀䴀관琞 欀栀꤀甞 ᄀ 渀栀관瀞 欀栀渀最 欀栀瀞℀∀ഀഀ
"[english]GameUI_PasswordsDontMatch"	"Entered passwords don't match!"਍∀䜀愀洀攀唀䤀开䴀甀猀琀䔀渀琀攀爀倀愀猀猀眀漀爀搀∀ऀ∀䈀ꄀ渞 瀀栀ꌀ椞 渀栀관瀞 洀琞 洀관琞 欀栀꤀甞∀ഀഀ
"[english]GameUI_MustEnterPassword"	"You must enter a password"਍∀䜀愀洀攀唀䤀开䤀渀挀漀爀爀攀挀琀倀愀猀猀眀漀爀搀∀ऀ∀匀愀椀 洀관琞 欀栀꤀甞∀ഀഀ
"[english]GameUI_IncorrectPassword"	"Incorrect password"਍∀䜀愀洀攀唀䤀开䌀愀渀琀䐀椀猀愀戀氀攀䌀漀渀琀攀渀琀䌀琀爀氀∀ऀ∀䬀栀渀最 琀栀쌀„琀꼀琞Ⰰ 欀椀쌀洞 猀漀琀 渀椞 搀甀渀最 挀栀뀀愁 ᄀ뀁挞 ᄀ뜁琞∀ഀഀ
"[english]GameUI_CantDisableContentCtrl"	"Can't disable, content control was not set"਍∀䜀愀洀攀唀䤀开䰀漀愀搀椀渀最∀ऀ∀က䄁一䜀 吀ꈀ䤞⸀⸀⸀∀ഀഀ
"[english]GameUI_Loading"	"LOADING..."਍∀䜀愀洀攀唀䤀开䰀漀愀搀椀渀最䜀愀洀攀∀ऀ∀က䄁一䜀 吀ꈀ䤞∀ഀഀ
"[english]GameUI_LoadingGame"	"LOADING"਍∀䜀愀洀攀唀䤀开䐀椀猀挀漀渀渀攀挀琀攀搀∀ऀ∀က 渀最꼀琞 欀뼀琞 渀턀椞∀ഀഀ
"[english]GameUI_Disconnected"	"Disconnected"਍∀䜀愀洀攀唀䤀开䌀漀渀渀攀挀琀椀漀渀䘀愀椀氀攀搀∀ऀ∀䬀栀渀最 琀栀쌀„欀뼀琞 渀턀椞 琀椞 洀礀 挀栀⸞∀ഀഀ
"[english]GameUI_ConnectionFailed"	"Could not connect to server."਍∀䜀愀洀攀唀䤀开䐀椀猀挀漀渀渀攀挀琀攀搀䘀爀漀洀∀ऀ∀䈀ꄀ渞 ᄀ 戀쬀„洀ꔀ琞 欀뼀琞 渀턀椞 瘀椞 洀礀 挀栀⸞∀ഀഀ
"[english]GameUI_DisconnectedFrom"	"You have been disconnected from the server."਍∀䜀愀洀攀唀䤀开䐀椀猀挀漀渀渀攀挀琀攀搀䘀爀漀洀匀攀爀瘀攀爀䔀砀琀攀渀搀攀搀∀ऀ∀䈀ꄀ渞 ᄀ 戀쬀„洀ꔀ琞 欀뼀琞 渀턀椞 瘀椞 洀礀 挀栀⸞尀渀䰀ﴀ 搀漀㨀 ─猀㄀∀ഀഀ
"[english]GameUI_DisconnectedFromServerExtended"	"You have been disconnected from the server.\nReason: %s1"਍∀䜀愀洀攀唀䤀开䔀猀琀愀戀氀椀猀栀椀渀最䌀漀渀渀攀挀琀椀漀渀∀ऀ∀က愁渀最 琀栀椀뼀琞 氀관瀞 欀뼀琞 渀턀椞 琀椞 洀礀 挀栀⸞⸀⸀∀ഀഀ
"[english]GameUI_EstablishingConnection"	"Establishing network connection to server..."਍∀䜀愀洀攀唀䤀开倀愀爀猀攀匀攀爀瘀攀爀䤀渀昀漀∀ऀ∀倀栀渀 琀挀栀 琀栀渀最 琀椀渀 洀礀 挀栀⸞⸀⸀∀ഀഀ
"[english]GameUI_ParseServerInfo"	"Parsing server info..."਍∀䜀愀洀攀唀䤀开䌀栀攀挀欀䌀刀䌀猀∀ऀ∀က愁渀最 砀挀 琀栀挞 琀椀 渀最甀礀渀 琀爀 挀栀ꄀ椁⸀⸀⸀∀ഀഀ
"[english]GameUI_CheckCRCs"	"Validating game resources..."਍∀䜀愀洀攀唀䤀开倀爀攀挀愀挀栀攀刀攀猀漀甀爀挀攀猀∀ऀ∀က愁渀最 琀ꌀ椞 琀椀 渀最甀礀渀 琀爀 挀栀ꄀ椁⸀⸀⸀∀ഀഀ
"[english]GameUI_PrecacheResources"	"Loading game resources..."਍∀䜀愀洀攀唀䤀开倀愀爀猀攀䈀愀猀攀氀椀渀攀∀ऀ∀倀栀渀 琀挀栀 琀栀渀最 琀椀渀 琀爀관渞 ᄀꔁ甞⸀⸀⸀∀ഀഀ
"[english]GameUI_ParseBaseline"	"Parsing game info..."਍∀䜀愀洀攀唀䤀开匀琀愀爀琀椀渀最匀攀爀瘀攀爀∀ऀ∀က愁渀最 欀栀?椞 ᄀ渞最 洀礀 挀栀„挀挞 戀⸞⸀⸀∀ഀഀ
"[english]GameUI_StartingServer"	"Starting local game server..."਍∀䜀愀洀攀唀䤀开䐀椀猀瀀氀愀礀䴀漀搀攀∀ऀ∀䌀栀뼀„ᄀ„栀椀쌀渞 琀栀쬀∞ഀഀ
"[english]GameUI_DisplayMode"	"Display mode"਍∀䜀愀洀攀唀䤀开䘀甀氀氀猀挀爀攀攀渀∀ऀ∀吀漀渀 洀渀 栀渀栀∀ഀഀ
"[english]GameUI_Fullscreen"	"Full screen"਍∀䜀愀洀攀唀䤀开䄀猀瀀攀挀琀刀愀琀椀漀∀ऀ∀吀준„氀윀„欀栀甀渀最 栀渀栀∀ഀഀ
"[english]GameUI_AspectRatio"	"Aspect Ratio"਍∀䜀愀洀攀唀䤀开䄀猀瀀攀挀琀一漀爀洀愀氀∀ऀ∀䈀渀栀 琀栀뀀?渞最 ⠀㐀㨀㌀⤀∀ഀഀ
"[english]GameUI_AspectNormal"	"Normal (4:3)"਍∀䜀愀洀攀唀䤀开䄀猀瀀攀挀琀圀椀搀攀㄀㘀砀㤀∀ऀ∀䴀渀 栀渀栀 爀渞最 ㄀㘀㨀㤀∀ഀഀ
"[english]GameUI_AspectWide16x9"	"Widescreen 16:9"਍∀䜀愀洀攀唀䤀开䄀猀瀀攀挀琀圀椀搀攀㄀㘀砀㄀　∀ऀ∀䴀渀 栀渀栀 爀渞最 ㄀㘀㨀㄀　∀ഀഀ
"[english]GameUI_AspectWide16x10"	"Widescreen 16:10"਍∀䜀愀洀攀唀䤀开䄀猀瀀攀挀琀圀椀搀攀∀ऀ∀䴀渀 栀渀栀 爀渞最∀ഀഀ
"[english]GameUI_AspectWide"	"Widescreen"਍∀䜀愀洀攀唀䤀开䌀䐀䬀攀礀∀ऀ∀䴀 䌀䐀∀ഀഀ
"[english]GameUI_CDKey"	"CD Key"਍∀䜀愀洀攀唀䤀开䔀渀琀攀爀䌀䐀䬀攀礀∀ऀ∀䠀礀 渀栀관瀞 洀 䌀䐀 ᄀ뀁挞 椀渀尀渀琀爀渀 栀瀞 ᄀ⤁愁 挀愞 戀ꄀ渞⸀∀ഀഀ
"[english]GameUI_EnterCDKey"	"Please enter your CD Key, which can be\nfound printed on your CD jewel case."਍∀䜀愀洀攀唀䤀开䰀漀愀搀椀渀最䐀椀愀氀漀最开䌀漀渀琀攀渀琀䠀漀猀琀椀渀最∀ऀ∀一栀 挀甀渀最 挀ꔀ瀞 渀椞 搀甀渀最㨀∀ഀഀ
"[english]GameUI_LoadingDialog_ContentHosting"	"Content hosting provided by:"਍∀䜀愀洀攀唀䤀开䌀漀氀漀爀匀氀椀搀攀爀猀∀ऀ∀䴀甀 猀꼀挞∀ഀഀ
"[english]GameUI_ColorSliders"	"Colors"਍∀䜀愀洀攀唀䤀开䌀漀氀漀爀儀甀愀氀椀琀礀∀ऀ∀䌀栀ꔀ琞 氀뀀渞最 洀甀 猀꼀挞∀ഀഀ
"[english]GameUI_ColorQuality"	"Color Quality"਍∀䜀愀洀攀唀䤀开䌀䐀䬀攀礀开䤀渀瘀愀氀椀搀开吀攀砀琀∀ऀ∀䴀 䌀䐀 戀ꄀ渞 渀栀관瀞 欀栀渀最 栀瀞 氀윀⸞∀ഀഀ
"[english]GameUI_CDKey_Invalid_Text"	"The CD Key you have entered is invalid."਍∀䜀愀洀攀唀䤀开䌀䐀䬀攀礀开䤀渀瘀愀氀椀搀开吀椀琀氀攀∀ऀ∀䴀쌀 䌀䐀 匀䄀䤀∀ഀഀ
"[english]GameUI_CDKey_Invalid_Title"	"INCORRECT CD KEY"਍∀䜀愀洀攀唀䤀开䌀䐀䬀攀礀开吀漀漀䴀愀渀礀吀爀椀攀猀∀ऀ∀一栀관瀞 猀愀椀 洀 䌀䐀 焀甀 渀栀椀섀甞 氀꜀渞⸀ က愁渀最 琀栀漀琀⸀⸀⸀∀ഀഀ
"[english]GameUI_CDKey_TooManyTries"	"Incorrect CD Key entered too many times. Exiting..."਍∀䜀愀洀攀唀䤀开䜀愀洀攀䴀攀渀甀开刀攀猀甀洀攀䜀愀洀攀∀ऀ∀吀䤀븀倞 吀䌞 䌀䠀ꀀ䤁∀ഀഀ
"[english]GameUI_GameMenu_ResumeGame"	"RESUME GAME"਍∀䜀愀洀攀唀䤀开䜀愀洀攀䴀攀渀甀开䐀椀猀挀漀渀渀攀挀琀∀ऀ∀一䜀글吞 䬀븀吞 一퀀䤞∀ഀഀ
"[english]GameUI_GameMenu_Disconnect"	"DISCONNECT"਍∀䜀愀洀攀唀䤀开䜀愀洀攀䴀攀渀甀开䌀栀愀渀最攀䜀愀洀攀∀ऀ∀吀䠀䄀夀 က퐁䤞 吀刀툀 䌀䠀ꀀ䤁∀ഀഀ
"[english]GameUI_GameMenu_ChangeGame"	"CHANGE GAME"਍∀䜀愀洀攀唀䤀开䜀愀洀攀䴀攀渀甀开倀氀愀礀攀爀䰀椀猀琀∀ऀ∀吀글吞 吀䤀븀丞䜀 一䜀꼀?䤞 䌀䠀ꀀ䤁∀ഀഀ
"[english]GameUI_GameMenu_PlayerList"	"MUTE PLAYERS"਍∀䜀愀洀攀唀䤀开伀甀琀伀昀䐀愀琀攀开吀椀琀氀攀∀ऀ∀倀䠀䤀쨀一 䈀ꈀ丞 吀刀툀 䌀䠀ꀀ䤁 က쌁 䰀혀䤞 吀䠀?䤞∀ഀഀ
"[english]GameUI_OutOfDate_Title"	"GAME IS OUT OF DATE"਍∀䜀愀洀攀唀䤀开伀甀琀伀昀䐀愀琀攀开唀刀䰀∀ऀ∀栀琀琀瀀㨀⼀⼀眀眀眀⸀猀琀攀愀洀瀀漀眀攀爀攀搀⸀挀漀洀⼀愀甀琀漀甀瀀搀愀琀攀∀ഀഀ
"[english]GameUI_OutOfDate_URL"	"http://www.steampowered.com/autoupdate"਍∀䜀愀洀攀唀䤀开伀甀琀伀昀䐀愀琀攀开䴀猀最∀ऀ∀倀栀椀渀 戀ꌀ渞 琀爀 挀栀ꄀ椁 ᄀ 氀휀椞 琀栀?椞⸀尀渀一栀ꔀ瀞 伀䬀 ᄀ쌁„琀椞 琀爀愀渀最 眀攀戀 挀愞 嘀愀氀瘀攀 瘀 琀ꌀ椞 挀挀 挀관瀞 渀栀관琞 洀椞 渀栀ꔀ琞⸀∀ഀഀ
"[english]GameUI_OutOfDate_Msg"	"Your game is out of date.\nClick OK to go to Valve's webpage to download the latest updates."਍∀䜀愀洀攀唀䤀开儀甀椀琀䌀漀渀昀椀爀洀愀琀椀漀渀吀椀琀氀攀∀ऀ∀吀䠀伀섀吀 吀刀툀 䌀䠀ꀀ䤁∀ഀഀ
"[english]GameUI_QuitConfirmationTitle"	"QUIT GAME"਍∀䜀愀洀攀唀䤀开儀甀椀琀䌀漀渀昀椀爀洀愀琀椀漀渀吀攀砀琀∀ऀ∀䈀ꄀ渞 挀 洀甀턀渞 渀最渞最 挀栀ꄀ椁 欀栀渀最㼀∀ഀഀ
"[english]GameUI_QuitConfirmationText"	"Do you wish to stop playing now?"਍∀䜀愀洀攀唀䤀开䐀椀猀挀漀渀渀攀挀琀∀ऀ∀一最꼀琞 欀뼀琞 渀턀椞∀ഀഀ
"[english]GameUI_Disconnect"	"Disconnect"਍∀䜀愀洀攀唀䤀开䐀椀猀挀漀渀渀攀挀琀䌀漀渀昀椀爀洀愀琀椀漀渀吀攀砀琀∀ऀ∀䈀ꄀ渞 挀 挀栀꼀挞 洀甀턀渞 琀栀漀琀 琀爀 挀栀ꄀ椁 渀礀㼀∀ഀഀ
"[english]GameUI_DisconnectConfirmationText"	"Are you sure you want to leave this game?"਍∀䜀愀洀攀唀䤀开䐀椀猀挀漀渀渀攀挀琀䠀漀猀琀䌀漀渀昀椀爀洀愀琀椀漀渀吀攀砀琀∀ऀ∀䌀栀ꔀ洞 搀琞 欀뼀琞 渀턀椞 猀봀„ᄀ甁픀椞 琀ꔀ琞 挀ꌀ„渀最뀀?椞 挀栀ꄀ椁⸀ 䈀ꄀ渞 挀 挀栀꼀挞 氀 洀甀턀渞 琀栀漀琀 欀栀케椞 琀爀 挀栀ꄀ椁 渀礀㼀∀ഀഀ
"[english]GameUI_DisconnectHostConfirmationText"	"Disconnecting will kick all players. Are you sure you want to leave this game?"਍∀䜀愀洀攀唀䤀开䌀栀愀渀最攀䜀愀洀攀∀ऀ∀က픁椞 琀爀 挀栀ꄀ椁∀ഀഀ
"[english]GameUI_ChangeGame"	"Change game"਍∀䜀愀洀攀唀䤀开一漀伀琀栀攀爀䜀愀洀攀猀䄀瘀愀椀氀愀戀氀攀∀ऀ∀䬀栀渀最 挀 琀爀관渞 ᄀꔁ甞 渀漀 欀栀挀 挀 琀栀쌀„琀栀愀洀 最椀愀⸀∀ഀഀ
"[english]GameUI_NoOtherGamesAvailable"	"There are no other games available to play."਍∀䜀愀洀攀唀䤀开䘀漀爀挀攀䜀愀洀攀刀攀猀琀愀爀琀∀ऀ∀吀栀愀礀 ᄀ픁椞 琀爀 挀栀ꄀ椁 猀봀„欀栀椀뼀渞 攀渀最椀渀攀 欀栀?椞 ᄀ渞最 氀ꄀ椞⸀∀ഀഀ
"[english]GameUI_ForceGameRestart"	"Changing games will cause the engine to restart."਍∀䜀愀洀攀唀䤀开䴀椀氀攀猀开嘀漀椀挀攀∀ऀ∀匀„搀渞最 䴀椀氀攀猀 匀漀甀渀搀 匀礀猀琀攀洀⸀ 䈀ꌀ渞 焀甀礀섀渞 ꤀ ㄀㤀㤀㄀ⴀ㈀　　㄀ 挀愞 刀䄀䐀 䜀愀洀攀 吀漀漀氀猀Ⰰ 䤀渀挀⸀∀ഀഀ
"[english]GameUI_Miles_Voice"	"Uses Miles Sound System. Copyright © 1991-2001 by RAD Game Tools, Inc."਍∀䜀愀洀攀唀䤀开䴀甀琀攀䤀渀最愀洀攀嘀漀椀挀攀∀ऀ∀吀꼀琞 氀?椞 琀栀漀ꄀ椞 琀爀漀渀最 琀爀 挀栀ꄀ椁∀ഀഀ
"[english]GameUI_MuteIngameVoice"	"Mute in-game voice"਍∀䜀愀洀攀唀䤀开唀渀洀甀琀攀䤀渀最愀洀攀嘀漀椀挀攀∀ऀ∀䈀관琞 氀?椞 琀栀漀ꄀ椞 琀爀漀渀最 琀爀 挀栀ꄀ椁∀ഀഀ
"[english]GameUI_UnmuteIngameVoice"	"Unmute in-game voice"਍∀䜀愀洀攀唀䤀开倀氀愀礀攀爀䰀椀猀琀䐀椀愀氀漀最吀椀琀氀攀∀ऀ∀一䜀꼀?䤞 䌀䠀ꀀ䤁 䠀䤀였丞 吀ꀀ䤞 ⴀ ─猀攀爀瘀攀爀─∀ഀഀ
"[english]GameUI_PlayerListDialogTitle"	"CURRENT PLAYERS - %server%"਍∀䜀愀洀攀唀䤀开䘀爀椀攀渀搀猀一愀洀攀∀ऀ∀吀渀 戀ꄀ渞 戀∀ഀഀ
"[english]GameUI_FriendsName"	"Friends name"਍∀䜀愀洀攀唀䤀开倀爀漀瀀攀爀琀椀攀猀∀ऀ∀吀栀椀뼀琞 氀관瀞∀ഀഀ
"[english]GameUI_Properties"	"Properties"਍∀䜀愀洀攀唀䤀开䄀搀搀䘀爀椀攀渀搀吀椀琀氀攀∀ऀ∀䈀ꀀ丞 䈀저 ⴀ 吀䠀쨀䴀 䈀ꀀ丞∀ഀഀ
"[english]GameUI_AddFriendTitle"	"FRIENDS - ADD FRIEND"਍∀䜀愀洀攀唀䤀开䘀爀椀攀渀搀䄀搀搀攀搀吀漀䰀椀猀琀∀ऀ∀─渀愀洀攀─ ᄀ ᄀ뀁挞 琀栀洀 瘀漀 搀愀渀栀 猀挀栀 戀ꄀ渞 戀 挀愞 戀ꄀ渞⸀尀渀䌀栀切 ﴀ 爀넀渞最 琀渀 栀촀„猀봀„欀栀渀最 栀椀쌀渞 琀栀쬀„氀 琀爀挞 琀甀礀뼀渞 ᄀ뼁渞 欀栀椀 栀촀„挀栀ꔀ瀞 渀栀관渞 礀甀 挀꜀甞 欀뼀琞 戀ꄀ渞 挀愞 戀ꄀ渞⸀∀ഀഀ
"[english]GameUI_FriendAddedToList"	"%name% has been added to your friends list.\nNote that they will not show up as online until they have accepted your friendship request."਍∀䜀愀洀攀唀䤀开䄀搀搀䘀爀椀攀渀搀䘀愀椀氀攀搀∀ऀ∀─渀愀洀攀─ 欀栀渀最 琀栀쌀„ᄀ뀁挞 琀栀洀 瘀漀 搀愀渀栀 猀挀栀 挀愞 戀ꄀ渞⸀尀渀䌀 琀栀쌀„ᄀ 砀ꌀ礞 爀愀 氀휀椞 欀뼀琞 渀턀椞 栀漀뜀挞 渀最뀀?椞 ᄀ ᄀ愁渀最 欀栀渀最 洀?„䈀ꄀ渞 戀⸀∀ഀഀ
"[english]GameUI_AddFriendFailed"	"%name% could not be added to your list.\nThere was either a connection error, or they are not running Friends."਍∀䜀愀洀攀唀䤀开一漀伀琀栀攀爀倀氀愀礀攀爀猀䤀渀䜀愀洀攀∀ऀ∀䬀栀渀最 挀 渀最뀀?椞 挀栀ꄀ椁 渀漀 欀栀挀 琀爀漀渀最 琀爀관渞⸀∀ഀഀ
"[english]GameUI_NoOtherPlayersInGame"	"There are no other players in the game."਍∀䜀愀洀攀唀䤀开儀甀椀挀欀匀愀瘀攀∀ऀ∀䰀꼀唁 一䠀䄀一䠀∀ഀഀ
"[english]GameUI_QuickSave"	"QUICK SAVE"਍∀䜀愀洀攀唀䤀开䄀甀琀漀匀愀瘀攀∀ऀ∀吀„က丞䜀 䰀꼀唁∀ഀഀ
"[english]GameUI_AutoSave"	"AUTO SAVE"਍∀䜀愀洀攀唀䤀开䄀甀琀漀匀愀瘀攀䰀愀戀攀氀∀ऀ∀吀„က丞䜀㨀∀ഀഀ
"[english]GameUI_AutoSaveLabel"	"AUTO:"਍∀䜀愀洀攀唀䤀开唀猀攀爀匀愀瘀攀䰀愀戀攀氀∀ऀ∀一䜀꼀?䤞 䐀一䜀㨀∀ഀഀ
"[english]GameUI_UserSaveLabel"	"USER:"਍∀䜀愀洀攀唀䤀开吀礀瀀攀∀ऀ∀䰀漀ꄀ椞∀ഀഀ
"[english]GameUI_Type"	"Type"਍∀䜀愀洀攀唀䤀开匀攀爀瘀攀爀一愀洀攀∀ऀ∀吀渀 洀礀 挀栀∞ഀഀ
"[english]GameUI_ServerName"	"Server name"਍∀䜀愀洀攀唀䤀开䴀愀砀倀氀愀礀攀爀猀∀ऀ∀匀턀„渀最뀀?椞 挀栀ꄀ椁 琀턀椞 ᄀ愁㨀∀ഀഀ
"[english]GameUI_MaxPlayers"	"Max. Players:"਍∀䜀愀洀攀唀䤀开倀愀猀猀眀漀爀搀∀ऀ∀䴀관琞 欀栀꤀甞∀ഀഀ
"[english]GameUI_Password"	"Password"਍∀䜀愀洀攀唀䤀开䐀䄀刀䬀∀ऀ∀吀퀀䤞∀ഀഀ
"[english]GameUI_DARK"	"DARK"਍∀䜀愀洀攀唀䤀开䰀䤀䜀䠀吀∀ऀ∀匀섀一䜀∀ഀഀ
"[english]GameUI_LIGHT"	"LIGHT"਍∀䜀愀洀攀唀䤀开嘀攀爀椀昀礀椀渀最刀攀猀漀甀爀挀攀猀∀ऀ∀堀挀 洀椀渀栀 琀椀 渀最甀礀渀⸀⸀⸀∀ഀഀ
"[english]GameUI_VerifyingResources"	"Verifying resources..."਍∀䜀愀洀攀唀䤀开嘀攀爀椀昀礀椀渀最䄀渀搀䐀漀眀渀氀漀愀搀椀渀最∀ऀ∀က愁渀最 砀挀 渀栀관渞 瘀 琀ꌀ椞 砀甀턀渞最 琀椀 渀最甀礀渀⸀⸀⸀∀ഀഀ
"[english]GameUI_VerifyingAndDownloading"	"Verifying and downloading resources..."਍∀䜀愀洀攀唀䤀开唀瀀搀愀琀椀渀最匀琀攀愀洀刀攀猀漀甀爀挀攀猀∀ऀ∀က愁渀最 挀관瀞 渀栀관琞 琀椀 渀最甀礀渀 匀琀攀愀洀∀ഀഀ
"[english]GameUI_UpdatingSteamResources"	"Updating steam resources"਍∀䜀愀洀攀唀䤀开䐀漀眀渀氀漀愀搀䘀愀椀氀攀搀∀ऀ∀䬀栀渀最 琀栀쌀„琀ꌀ椞 砀甀턀渞最 ─猀㄀∀ഀഀ
"[english]GameUI_DownloadFailed"	"Could not download %s1"਍∀䜀愀洀攀唀䤀开䐀漀眀渀氀漀愀搀䘀愀椀氀攀搀娀攀爀漀䰀攀渀∀ऀ∀䬀栀渀最 琀栀쌀„琀ꌀ椞 砀甀턀渞最 ─猀㄀㨀尀渀吀윀瀞 欀栀渀最 挀 搀„氀椀윀甞∀ഀഀ
"[english]GameUI_DownloadFailedZeroLen"	"Could not download %s1:\nFile has no data"਍∀䜀愀洀攀唀䤀开䐀漀眀渀氀漀愀搀䘀愀椀氀攀搀䌀漀渀䌀氀漀猀攀搀∀ऀ∀䬀栀渀最 琀栀쌀„琀ꌀ椞 砀甀턀渞最 ─猀㄀㨀 尀渀䬀뼀琞 渀턀椞 戀쬀„ᄀ渀最 戀?椞 洀礀 挀栀„琀„砀愀∀ഀഀ
"[english]GameUI_DownloadFailedConClosed"	"Could not download %s1:\nConnection closed by remote host"਍∀䜀愀洀攀唀䤀开䐀漀眀渀氀漀愀搀䘀愀椀氀攀搀䈀愀搀唀刀䰀∀ऀ∀䬀栀渀最 琀栀쌀„琀ꌀ椞 砀甀턀渞最 ─猀㄀㨀尀渀唀刀䰀 欀栀渀最 栀瀞 氀윀∞ഀഀ
"[english]GameUI_DownloadFailedBadURL"	"Could not download %s1:\nInvalid URL"਍∀䜀愀洀攀唀䤀开䐀漀眀渀氀漀愀搀䘀愀椀氀攀搀䈀愀搀倀爀漀琀漀挀漀氀∀ऀ∀䬀栀渀最 琀栀쌀„琀ꌀ椞 砀甀턀渞最 ─猀㄀㨀尀渀䌀栀준„栀휀„琀爀„䠀吀吀倀∀ഀഀ
"[english]GameUI_DownloadFailedBadProtocol"	"Could not download %s1:\nOnly HTTP is supported"਍∀䜀愀洀攀唀䤀开䐀漀眀渀氀漀愀搀䘀愀椀氀攀搀䌀愀渀琀䈀椀渀搀∀ऀ∀䬀栀渀最 琀栀쌀„琀ꌀ椞 砀甀턀渞最 ─猀㄀㨀尀渀䬀栀渀最 琀栀쌀„氀椀渀 欀뼀琞 猀漀挀欀攀琀∀ഀഀ
"[english]GameUI_DownloadFailedCantBind"	"Could not download %s1:\nCannot bind a socket"਍∀䜀愀洀攀唀䤀开䐀漀眀渀氀漀愀搀䘀愀椀氀攀搀䌀愀渀琀䌀漀渀渀攀挀琀∀ऀ∀䬀栀渀最 琀栀쌀„琀ꌀ椞 砀甀턀渞最 ─猀㄀㨀尀渀䬀栀渀最 琀栀쌀„欀뼀琞 渀턀椞 ᄀ뼁渞 洀礀 挀栀∞ഀഀ
"[english]GameUI_DownloadFailedCantConnect"	"Could not download %s1:\nCannot connect to server"਍∀䜀愀洀攀唀䤀开䐀漀眀渀氀漀愀搀䘀愀椀氀攀搀一漀䠀攀愀搀攀爀猀∀ऀ∀䬀栀渀最 琀栀쌀„琀ꌀ椞 砀甀턀渞最 ─猀㄀㨀尀渀䬀栀渀最 琀栀쌀„氀ꔀ礞 琀栀渀最 琀椀渀 琀윀瀞 琀„洀礀 挀栀∞ഀഀ
"[english]GameUI_DownloadFailedNoHeaders"	"Could not download %s1:\nCannot get file info from server"਍∀䜀愀洀攀唀䤀开䐀漀眀渀氀漀愀搀䘀愀椀氀攀搀䘀椀氀攀一漀琀䘀漀甀渀搀∀ऀ∀䬀栀渀最 琀栀쌀„琀ꌀ椞 砀甀턀渞最 ─猀㄀㨀尀渀吀윀瀞 欀栀渀最 琀팀渞 琀ꄀ椞∀ഀഀ
"[english]GameUI_DownloadFailedFileNotFound"	"Could not download %s1:\nFile does not exist"਍∀䜀愀洀攀唀䤀开䌀甀爀爀攀渀琀倀氀愀礀攀爀猀∀ऀ∀吀글吞 吀䤀븀丞䜀 一䜀꼀?䤞 䌀䠀ꀀ䤁∀ഀഀ
"[english]GameUI_CurrentPlayers"	"MUTE PLAYERS"਍∀䜀愀洀攀唀䤀开䰀漀愀搀椀渀最䘀椀氀攀渀愀洀攀∀ऀ∀က愁渀最 琀ꌀ椞 ─猀㄀ ⸀⸀⸀∀ഀഀ
"[english]GameUI_LoadingFilename"	"Loading %s1 ..."਍∀䜀愀洀攀唀䤀开䔀瘀攀渀琀䰀椀猀琀∀ऀ∀䐀愀渀栀 猀挀栀 猀„欀椀윀渞∀ഀഀ
"[english]GameUI_EventList"	"Event List"਍∀䜀愀洀攀唀䤀开䜀攀琀吀椀洀攀∀ऀ∀䰀ꔀ礞 琀栀?椞 最椀愀渀∀ഀഀ
"[english]GameUI_GetTime"	"Get time"਍∀䜀愀洀攀唀䤀开䄀搀搀∀ऀ∀吀栀洀∀ഀഀ
"[english]GameUI_Add"	"Add"਍∀䜀愀洀攀唀䤀开刀攀洀漀瘀攀∀ऀ∀䜀„戀케∞ഀഀ
"[english]GameUI_Remove"	"Remove"਍∀䜀愀洀攀唀䤀开䴀漀搀椀昀礀∀ऀ∀䌀栀준渞栀 猀愞∀ഀഀ
"[english]GameUI_Modify"	"Modify"਍∀䜀愀洀攀唀䤀开䜀漀琀漀∀ऀ∀က椁 ᄀ뼁渞∀ഀഀ
"[english]GameUI_Goto"	"Goto"਍∀䜀愀洀攀唀䤀开䔀瘀攀渀琀猀∀ऀ∀匀„欀椀윀渞∀ഀഀ
"[english]GameUI_Events"	"Events"਍∀䜀愀洀攀唀䤀开匀愀瘀攀∀ऀ∀䰀뀀甁∀ഀഀ
"[english]GameUI_Save"	"Save"਍∀䜀愀洀攀唀䤀开吀椀洀攀∀ऀ∀吀栀?椞 最椀愀渀∀ഀഀ
"[english]GameUI_Time"	"Time"਍∀䜀愀洀攀唀䤀开䌀倀唀倀氀愀礀攀爀伀瀀琀椀漀渀猀∀ऀ∀吀豈礀 挀栀촀渞 渀最뀀?椞 挀栀ꄀ椁 䌀倀唀∀ഀഀ
"[english]GameUI_CPUPlayerOptions"	"CPU Player Options"਍∀䜀愀洀攀唀䤀开䴀攀搀椀甀洀䈀椀琀䐀攀瀀琀栀∀ऀ∀吀爀甀渀最 戀渀栀 ⠀㄀㘀 戀椀琀⤀∀ഀഀ
"[english]GameUI_MediumBitDepth"	"Medium (16 bit)"਍∀䜀愀洀攀唀䤀开䠀椀最栀䈀椀琀䐀攀瀀琀栀∀ऀ∀䌀愀漀 渀栀ꔀ琞 ⠀㌀㈀ 戀椀琀⤀∀ഀഀ
"[english]GameUI_HighBitDepth"	"Highest (32 bit)"਍∀䜀愀洀攀唀䤀开匀攀爀瘀攀爀䌀漀渀渀攀挀琀椀漀渀吀椀洀攀漀甀琀∀ऀ∀䠀뼀琞 琀栀?椞 最椀愀渀 欀뼀琞 渀턀椞 琀椞 洀礀 挀栀⸞∀ഀഀ
"[english]GameUI_ServerConnectionTimeout"	"Connection to server timed out."਍∀䜀愀洀攀唀䤀开匀攀爀瘀攀爀䌀漀渀渀攀挀琀椀漀渀䘀愀椀氀攀搀䈀愀搀倀愀猀猀眀漀爀搀∀ऀ∀䬀뼀琞 渀턀椞 ᄀ뼁渞 洀礀 挀栀„琀爀 挀栀ꄀ椁 戀쬀„琀„挀栀턀椞⸀尀渀䴀관琞 欀栀꤀甞 戀ꄀ渞 瘀愞 渀栀관瀞 欀栀渀最 挀栀渀栀 砀挀⸀∀ഀഀ
"[english]GameUI_ServerConnectionFailedBadPassword"	"Connection to game server refused.\nThe password you entered was incorrect."਍∀䜀愀洀攀唀䤀开匀愀瘀攀䜀愀洀攀开一攀眀匀愀瘀攀搀䜀愀洀攀∀ऀ∀䈀ꌀ渞 氀뀀甁 洀椞∀ഀഀ
"[english]GameUI_SaveGame_NewSavedGame"	"New saved game"਍∀䜀愀洀攀唀䤀开匀愀瘀攀䜀愀洀攀开一攀眀匀愀瘀攀∀ऀ∀䈀ꌀ渞 挀栀ꄀ椁 洀椞∀ഀഀ
"[english]GameUI_SaveGame_NewSave"	"New Save"਍∀䜀愀洀攀唀䤀开匀愀瘀攀䜀愀洀攀开一攀眀∀ऀ∀䴀椞∀ഀഀ
"[english]GameUI_SaveGame_New"	"New"਍∀䜀愀洀攀唀䤀开匀愀瘀攀䜀愀洀攀开䌀甀爀爀攀渀琀∀ऀ∀䠀椀윀渞 琀ꄀ椞∀ഀഀ
"[english]GameUI_SaveGame_Current"	"Current"਍∀䜀愀洀攀唀䤀开匀愀瘀攀䜀愀洀攀开伀瘀攀爀眀爀椀琀攀∀ऀ∀䜀栀椀 ᄀ 氀渀 戀ꌀ渞 氀뀀甁∀ഀഀ
"[english]GameUI_SaveGame_Overwrite"	"Overwrite Save"਍∀䜀愀洀攀唀䤀开䠀攀愀搀瀀栀漀渀攀猀∀ऀ∀吀愀椀 渀最栀攀∀ഀഀ
"[english]GameUI_Headphones"	"Headphones"਍∀䜀愀洀攀唀䤀开㈀匀瀀攀愀欀攀爀猀∀ऀ∀㈀ 䰀漀愀∀ഀഀ
"[english]GameUI_2Speakers"	"2 Speakers"਍∀䜀愀洀攀唀䤀开㐀匀瀀攀愀欀攀爀猀∀ऀ∀㐀 䰀漀愀∀ഀഀ
"[english]GameUI_4Speakers"	"4 Speakers"਍∀䜀愀洀攀唀䤀开㔀匀瀀攀愀欀攀爀猀∀ऀ∀㔀⸀㄀ 䰀漀愀∀ഀഀ
"[english]GameUI_5Speakers"	"5.1 Speakers"਍∀䜀愀洀攀唀䤀开㜀匀瀀攀愀欀攀爀猀∀ऀ∀㜀⸀㄀ 䰀漀愀∀ഀഀ
"[english]GameUI_7Speakers"	"7.1 Speakers"਍∀䜀愀洀攀唀䤀开匀瀀攀愀欀攀爀䌀漀渀昀椀最甀爀愀琀椀漀渀∀ऀ∀吀栀椀뼀琞 氀관瀞 氀漀愀∀ഀഀ
"[english]GameUI_SpeakerConfiguration"	"Speaker configuration"਍∀䜀愀洀攀唀䤀开一攀眀匀愀瘀攀䜀愀洀攀∀ऀ∀䈀ꈀ丞 䰀꼀唁 䴀䤞∀ഀഀ
"[english]GameUI_NewSaveGame"	"NEW SAVE GAME"਍∀䜀愀洀攀唀䤀开䌀漀渀昀椀爀洀䐀攀氀攀琀攀匀愀瘀攀䜀愀洀攀开吀椀琀氀攀∀ऀ∀堀伀섀 䈀ꈀ丞 䰀꼀唁㼀∀ഀഀ
"[english]GameUI_ConfirmDeleteSaveGame_Title"	"DELETE SAVE GAME?"਍∀䜀愀洀攀唀䤀开䌀漀渀昀椀爀洀䐀攀氀攀琀攀匀愀瘀攀䜀愀洀攀开䤀渀昀漀∀ऀ∀䈀ꄀ渞 挀 洀甀턀渞 砀愀 戀ꌀ渞 氀뀀甁 渀礀㼀尀渀一 猀봀„戀쬀„砀愀 瘀⤀渁栀 瘀椀씀渞⸀∀ഀഀ
"[english]GameUI_ConfirmDeleteSaveGame_Info"	"Do you want to delete this save game?\nIt will be deleted permanently."਍∀䜀愀洀攀唀䤀开䌀漀渀昀椀爀洀䐀攀氀攀琀攀匀愀瘀攀䜀愀洀攀开伀䬀∀ऀ∀堀愀∀ഀഀ
"[english]GameUI_ConfirmDeleteSaveGame_OK"	"Delete"਍∀䜀愀洀攀唀䤀开䌀漀渀昀椀爀洀伀瘀攀爀眀爀椀琀攀匀愀瘀攀䜀愀洀攀开吀椀琀氀攀∀ऀ∀䰀꼀唁 䜀䄀䴀䔀∀ഀഀ
"[english]GameUI_ConfirmOverwriteSaveGame_Title"	"SAVE GAME"਍∀䜀愀洀攀唀䤀开䌀漀渀昀椀爀洀伀瘀攀爀眀爀椀琀攀匀愀瘀攀䜀愀洀攀开䤀渀昀漀∀ऀ∀䈀ꄀ渞 挀 洀甀턀渞 最栀椀 ᄀ 氀渀 戀ꌀ渞 氀뀀甁 渀礀 欀栀渀最㼀∀ഀഀ
"[english]GameUI_ConfirmOverwriteSaveGame_Info"	"Do you want to overwrite this existing save game?"਍∀䜀愀洀攀唀䤀开䌀漀渀昀椀爀洀伀瘀攀爀眀爀椀琀攀匀愀瘀攀䜀愀洀攀开伀䬀∀ऀ∀䜀栀椀 ᄀ∀ഀഀ
"[english]GameUI_ConfirmOverwriteSaveGame_OK"	"Overwrite"਍∀䜀愀洀攀唀䤀开匀愀瘀椀渀最圀愀爀渀椀渀最∀ऀ∀က愁渀最 氀뀀甁 渀椞 搀甀渀最⸀尀渀嘀甀椀 氀渀最 欀栀渀最 琀꼀琞 琀栀椀뼀琞 戀쬀„挀愞 戀ꄀ渞⸀∀ഀഀ
"[english]GameUI_SavingWarning"	"Saving content.\nPlease don't turn off your console."਍∀䜀愀洀攀唀䤀开䜀愀洀攀匀愀瘀攀搀∀ऀ∀က 氀뀀甁 琀爀 挀栀ꄀ椁∀ഀഀ
"[english]GameUI_GameSaved"	"Game Saved"਍∀䜀愀洀攀唀䤀开䄀甀琀漀匀愀瘀攀开䌀漀渀猀漀氀攀开䔀砀瀀氀愀渀愀琀椀漀渀∀ऀ∀吀爀 挀栀ꄀ椁 渀礀 搀豈渀最 栀윀„琀栀턀渞最 琀„ᄀ渞最 氀뀀甁 琀椀뼀渞 ᄀ„挀愞 戀ꄀ渞 ᄀ쬁渞栀 欀„洀 欀栀渀最 挀ꌀ渞栀 戀漀⸀ 嘀甀椀 氀渀最 欀栀渀最 琀꼀琞 洀礀 堀戀漀砀 挀愞 戀ꄀ渞 琀爀漀渀最 欀栀椀 ᄀ愁渀最 氀뀀甁⸀∀ഀഀ
"[english]GameUI_AutoSave_Console_Explanation"	"This game uses an autosave system that will periodically save your progress without warning. Please do not turn off your Xbox console during an autosave."਍∀䜀愀洀攀唀䤀开䌀漀渀昀椀爀洀一攀眀䜀愀洀攀开吀椀琀氀攀∀ऀ∀吀刀툀 䌀䠀ꀀ䤁 䴀䤞∀ഀഀ
"[english]GameUI_ConfirmNewGame_Title"	"NEW GAME"਍∀䜀愀洀攀唀䤀开一攀眀䜀愀洀攀圀愀爀渀椀渀最∀ऀ∀䈀ꄀ渞 挀 挀栀꼀挞 洀渀栀 洀甀턀渞 戀꼀琞 ᄀ꜁甞 洀琞 戀ꌀ渞 挀栀ꄀ椁 洀椞㼀尀渀吀ꔀ琞 挀ꌀ„琀椀뼀渞 琀爀渀栀 挀栀뀀愁 ᄀ뀁挞 氀뀀甁 猀봀„戀쬀„洀ꔀ琞⸀∀ഀഀ
"[english]GameUI_NewGameWarning"	"Are you sure you want to start a new game?\nAll unsaved progress will be lost."਍∀䜀愀洀攀唀䤀开刀愀渀搀漀洀䴀愀瀀∀ऀ∀㰀 䈀ꌀ渞 ᄀ팁„渀最꬀甞 渀栀椀渀 㸀∀ഀഀ
"[english]GameUI_RandomMap"	"< Random Map >"਍∀䜀愀洀攀唀䤀开刀攀琀爀礀椀渀最䌀漀渀渀攀挀琀椀漀渀吀漀匀攀爀瘀攀爀∀ऀ∀က愁渀最 琀栀„氀ꄀ椞 欀뼀琞 渀턀椞 琀椞 洀礀 挀栀⸞⸀⸀∀ഀഀ
"[english]GameUI_RetryingConnectionToServer"	"Retrying connection to server..."਍∀䜀愀洀攀唀䤀开刀攀琀爀礀椀渀最䌀漀渀渀攀挀琀椀漀渀吀漀匀攀爀瘀攀爀㈀∀ऀ∀က愁渀最 琀栀„氀ꄀ椞 欀뼀琞 渀턀椞 琀椞 洀礀 挀栀„⠀㈀⤀⸀⸀⸀∀ഀഀ
"[english]GameUI_RetryingConnectionToServer2"	"Retrying connection to server (2)..."਍∀䜀愀洀攀唀䤀开刀攀琀爀礀椀渀最䌀漀渀渀攀挀琀椀漀渀吀漀匀攀爀瘀攀爀㌀∀ऀ∀က愁渀最 琀栀„氀ꄀ椞 欀뼀琞 渀턀椞 琀椞 洀礀 挀栀„⠀㌀⤀⸀⸀⸀∀ഀഀ
"[english]GameUI_RetryingConnectionToServer3"	"Retrying connection to server (3)..."਍∀䜀愀洀攀唀䤀开䌀漀甀氀搀一漀琀䌀漀渀琀愀挀琀䜀愀洀攀匀攀爀瘀攀爀∀ऀ∀䬀뼀琞 渀턀椞 ᄀ뼁渞 洀礀 挀栀„琀爀 挀栀ꄀ椁 琀栀ꔀ琞 戀ꄀ椞∀ഀഀ
"[english]GameUI_CouldNotContactGameServer"	"Failed to contact game server"਍∀䜀愀洀攀唀䤀开刀攀昀爀攀猀栀䰀漀最椀渀开䤀渀昀漀吀椀挀欀攀琀䔀砀瀀椀爀攀搀∀ऀ∀倀栀椀渀 ᄀ́渁最 渀栀관瀞 匀琀攀愀洀 ᄀ 栀뼀琞 栀ꄀ渞⸀尀渀嘀甀椀 氀渀最 渀栀관瀞 氀ꄀ椞 洀관琞 欀栀꤀甞 挀愞 戀ꄀ渞 ᄀ쌁„琀椀뼀瀞 琀挞⸀∀ഀഀ
"[english]GameUI_RefreshLogin_InfoTicketExpired"	"Your steam ticket has expired.\nPlease re-enter your password to continue."਍∀䜀愀洀攀唀䤀开刀攀昀爀攀猀栀䰀漀最椀渀开唀猀攀爀一愀洀攀∀ऀ∀吀渀 琀椀 欀栀漀ꌀ渞∀ഀഀ
"[english]GameUI_RefreshLogin_UserName"	"Account name"਍∀䜀愀洀攀唀䤀开刀攀昀爀攀猀栀䰀漀最椀渀开倀愀猀猀眀漀爀搀∀ऀ∀䴀관琞 欀栀꤀甞∀ഀഀ
"[english]GameUI_RefreshLogin_Password"	"Password"਍∀䜀愀洀攀唀䤀开刀攀昀爀攀猀栀䰀漀最椀渀开䰀漀最椀渀∀ऀ∀က́渁最 渀栀관瀞∀ഀഀ
"[english]GameUI_RefreshLogin_Login"	"Login"਍∀䜀愀洀攀唀䤀开刀攀昀爀攀猀栀䰀漀最椀渀开䌀愀渀挀攀氀∀ऀ∀䠀礞∀ഀഀ
"[english]GameUI_RefreshLogin_Cancel"	"Cancel"਍∀䜀愀洀攀唀䤀开刀攀昀爀攀猀栀䰀漀最椀渀∀ऀ∀䰀洀 洀椞 ᄀ́渁最 渀栀관瀞∀ഀഀ
"[english]GameUI_RefreshLogin"	"Refresh Login"਍∀䜀愀洀攀唀䤀开刀攀昀爀攀猀栀䰀漀最椀渀开刀攀洀攀洀戀攀爀倀愀猀猀眀漀爀搀∀ऀ∀一栀„洀관琞 欀栀꤀甞 挀愞 琀椀∀ഀഀ
"[english]GameUI_RefreshLogin_RememberPassword"	"Remember my password"਍∀䜀愀洀攀唀䤀开䰀漀最椀渀开䔀爀爀漀爀吀椀琀氀攀∀ऀ∀䰀洀 洀椞 ᄀ́渁最 渀栀관瀞 ⴀ 䰀휀椞∀ഀഀ
"[english]GameUI_Login_ErrorTitle"	"Refresh Login - Error"਍∀䜀愀洀攀唀䤀开䔀爀爀漀爀䰀漀最椀渀䘀愀椀氀攀搀∀ऀ∀က́渁最 渀栀관瀞 琀栀ꔀ琞 戀ꄀ椞⸀ 䠀礀 琀栀„氀ꄀ椞⸀∀ഀഀ
"[english]GameUI_ErrorLoginFailed"	"Login Failed. Please try again."਍∀䰀漀愀搀椀渀最倀爀漀最爀攀猀猀开匀瀀愀眀渀椀渀最匀攀爀瘀攀爀∀ऀ∀က愁渀最 欀栀?椞 ᄀ渞最 洀礀 挀栀„渀椞 戀⸞⸀⸀∀ഀഀ
"[english]LoadingProgress_SpawningServer"	"Starting local game server..."਍∀䰀漀愀搀椀渀最倀爀漀最爀攀猀猀开䰀漀愀搀䴀愀瀀∀ऀ∀က愁渀最 琀ꌀ椞 琀栀뼀„最椀椞⸀⸀⸀∀ഀഀ
"[english]LoadingProgress_LoadMap"	"Loading world..."਍∀䰀漀愀搀椀渀最倀爀漀最爀攀猀猀开倀爀攀挀愀挀栀攀圀漀爀氀搀∀ऀ∀䬀栀?椞 琀ꄀ漞 琀栀뼀„最椀椞⸀⸀⸀∀ഀഀ
"[english]LoadingProgress_PrecacheWorld"	"Initializing world..."਍∀䰀漀愀搀椀渀最倀爀漀最爀攀猀猀开䰀漀愀搀刀攀猀漀甀爀挀攀猀∀ऀ∀က愁渀最 琀ꌀ椞 琀椀 渀最甀礀渀⸀⸀⸀∀ഀഀ
"[english]LoadingProgress_LoadResources"	"Loading resources..."਍∀䰀漀愀搀椀渀最倀爀漀最爀攀猀猀开匀椀最渀漀渀䰀漀挀愀氀∀ऀ∀䬀栀?椞 琀ꄀ漞 琀椀 渀最甀礀渀⸀⸀⸀∀ഀഀ
"[english]LoadingProgress_SignonLocal"	"Initializing resources..."਍∀䰀漀愀搀椀渀最倀爀漀最爀攀猀猀开匀椀最渀漀渀䐀愀琀愀䰀漀挀愀氀∀ऀ∀က愁渀最 欀栀?椞 挀栀ꄀ礞 搀„氀椀윀甞 琀爀 挀栀ꄀ椁⸀⸀⸀∀ഀഀ
"[english]LoadingProgress_SignonDataLocal"	"Initializing game data..."਍∀䰀漀愀搀椀渀最倀爀漀最爀攀猀猀开䈀攀最椀渀䌀漀渀渀攀挀琀∀ऀ∀吀栀椀뼀琞 氀관瀞 欀뼀琞 渀턀椞 琀椞 洀礀 挀栀⸞⸀⸀∀ഀഀ
"[english]LoadingProgress_BeginConnect"	"Establishing connection to server..."਍∀䰀漀愀搀椀渀最倀爀漀最爀攀猀猀开䌀漀渀渀攀挀琀椀渀最∀ऀ∀က愁渀最 欀뼀琞 渀턀椞 琀椞 洀礀 挀栀⸞⸀⸀∀ഀഀ
"[english]LoadingProgress_Connecting"	"Connecting to server..."਍∀䰀漀愀搀椀渀最倀爀漀最爀攀猀猀开倀爀漀挀攀猀猀匀攀爀瘀攀爀䤀渀昀漀∀ऀ∀က愁渀最 渀栀관渞 琀栀渀最 琀椀渀 洀礀 挀栀⸞⸀⸀∀ഀഀ
"[english]LoadingProgress_ProcessServerInfo"	"Retrieving server info..."਍∀䰀漀愀搀椀渀最倀爀漀最爀攀猀猀开匀攀渀搀䌀氀椀攀渀琀䤀渀昀漀∀ऀ∀က愁渀最 最椞 琀栀渀最 琀椀渀 洀礀 欀栀挀栀⸀⸀⸀∀ഀഀ
"[english]LoadingProgress_SendClientInfo"	"Sending client info..."਍∀䰀漀愀搀椀渀最倀爀漀最爀攀猀猀开匀椀最渀漀渀䐀愀琀愀∀ऀ∀က愁渀最 渀栀관渞 搀„氀椀윀甞 琀爀 挀栀ꄀ椁⸀⸀⸀∀ഀഀ
"[english]LoadingProgress_SignonData"	"Retrieving game data..."਍∀䰀漀愀搀椀渀最倀爀漀最爀攀猀猀开䌀栀愀渀最攀氀攀瘀攀氀∀ऀ∀䴀礀 挀栀„ᄀ愁渀最 琀栀愀礀 ᄀ픁椞 洀渀⸀⸀⸀∀ഀഀ
"[english]LoadingProgress_Changelevel"	"Server is changing level..."਍∀䜀愀洀攀唀䤀开䐀椀昀昀椀挀甀氀琀礀∀ऀ∀က„欀栀∀ഀഀ
"[english]GameUI_Difficulty"	"Difficulty"਍∀䜀愀洀攀唀䤀开匀欀椀氀氀䔀愀猀礀∀ऀ∀䐀씀∞ഀഀ
"[english]GameUI_SkillEasy"	"Easy"਍∀䜀愀洀攀唀䤀开匀欀椀氀氀一漀爀洀愀氀∀ऀ∀䈀渀栀 琀栀뀀?渞最∀ഀഀ
"[english]GameUI_SkillNormal"	"Normal"਍∀䜀愀洀攀唀䤀开匀欀椀氀氀䠀愀爀搀∀ऀ∀䬀栀∀ഀഀ
"[english]GameUI_SkillHard"	"Hard"਍∀䜀愀洀攀唀䤀开匀攀氀攀挀琀䐀椀昀昀椀挀甀氀琀礀∀ऀ∀က„欀栀 挀栀椀뼀渞 ᄀꔁ甞㨀∀ഀഀ
"[english]GameUI_SelectDifficulty"	"Combat difficulty:"਍∀䜀愀洀攀唀䤀开倀漀爀琀愀氀䐀攀瀀琀栀　∀ऀ∀　∀ഀഀ
"[english]GameUI_PortalDepth0"	"0"਍∀䜀愀洀攀唀䤀开倀漀爀琀愀氀䐀攀瀀琀栀㄀∀ऀ∀㄀∀ഀഀ
"[english]GameUI_PortalDepth1"	"1"਍∀䜀愀洀攀唀䤀开倀漀爀琀愀氀䐀攀瀀琀栀㈀∀ऀ∀㈀ ⠀欀栀甀礀渀 搀豈渀最⤀∀ഀഀ
"[english]GameUI_PortalDepth2"	"2 (recommended)"਍∀䜀愀洀攀唀䤀开倀漀爀琀愀氀䐀攀瀀琀栀㌀∀ऀ∀㌀∀ഀഀ
"[english]GameUI_PortalDepth3"	"3"਍∀䜀愀洀攀唀䤀开倀漀爀琀愀氀䐀攀瀀琀栀㔀∀ऀ∀㔀∀ഀഀ
"[english]GameUI_PortalDepth5"	"5"਍∀䜀愀洀攀唀䤀开倀漀爀琀愀氀䐀攀瀀琀栀㘀∀ऀ∀㘀∀ഀഀ
"[english]GameUI_PortalDepth6"	"6"਍∀䜀愀洀攀唀䤀开倀漀爀琀愀氀䐀攀瀀琀栀㜀∀ऀ∀㜀∀ഀഀ
"[english]GameUI_PortalDepth7"	"7"਍∀䜀愀洀攀唀䤀开倀漀爀琀愀氀䐀攀瀀琀栀㠀∀ऀ∀㠀∀ഀഀ
"[english]GameUI_PortalDepth8"	"8"਍∀䜀愀洀攀唀䤀开倀漀爀琀愀氀䐀攀瀀琀栀㤀∀ऀ∀㤀∀ഀഀ
"[english]GameUI_PortalDepth9"	"9"਍∀䜀愀洀攀唀䤀开䌀爀漀猀猀栀愀椀爀䐀攀猀挀爀椀瀀琀椀漀渀∀ऀ∀䠀渀栀 搀ꄀ渞最 琀洀 渀最꼀洞∀ഀഀ
"[english]GameUI_CrosshairDescription"	"Crosshair appearance"਍∀䜀愀洀攀唀䤀开䄀甀琀漀∀ऀ∀䬀挀栀 挀„琀„ᄀ渞最∀ഀഀ
"[english]GameUI_Auto"	"Auto-size"਍∀䜀愀洀攀唀䤀开匀洀愀氀氀∀ऀ∀一栀케∞ഀഀ
"[english]GameUI_Small"	"Small"਍∀䜀愀洀攀唀䤀开䰀愀爀最攀∀ऀ∀䰀渞∀ഀഀ
"[english]GameUI_Large"	"Large"਍∀䜀愀洀攀唀䤀开䌀爀漀猀猀栀愀椀爀刀攀搀∀ऀ∀က켁∞ഀഀ
"[english]GameUI_CrosshairRed"	"Red"਍∀䜀愀洀攀唀䤀开䌀爀漀猀猀栀愀椀爀䜀爀攀攀渀∀ऀ∀堀愀渀栀 氀∀ഀഀ
"[english]GameUI_CrosshairGreen"	"Green"਍∀䜀愀洀攀唀䤀开䌀爀漀猀猀栀愀椀爀䈀氀甀攀∀ऀ∀堀愀渀栀 搀뀀ꄁ渁最∀ഀഀ
"[english]GameUI_CrosshairBlue"	"Blue"਍∀䜀愀洀攀唀䤀开䌀爀漀猀猀栀愀椀爀匀挀愀氀攀∀ऀ∀䬀挀栀 琀栀뀀挞∀ഀഀ
"[english]GameUI_CrosshairScale"	"Size"਍∀䜀愀洀攀唀䤀开䘀愀猀琀匀眀椀琀挀栀䌀栀攀挀欀∀ऀ∀䌀栀甀礀쌀渞 瘀椀 欀栀 渀栀愀渀栀∀ഀഀ
"[english]GameUI_FastSwitchCheck"	"Fast weapon switch"਍∀䜀愀洀攀唀䤀开䐀攀瘀攀氀漀瀀攀爀䌀漀渀猀漀氀攀䌀栀攀挀欀∀ऀ∀䴀?„戀ꌀ渞最 ᄀ椁섀甞 欀栀椀쌀渞 搀渀栀 挀栀漀 渀栀 瀀栀琀 琀爀椀쌀渞∀ഀഀ
"[english]GameUI_DeveloperConsoleCheck"	"Enable developer console"਍∀䜀愀洀攀唀䤀开䬀攀礀戀漀愀爀搀䄀搀瘀愀渀挀攀搀开吀椀琀氀攀∀ऀ∀䈀쀀一 倀䠀촀䴀 ⴀ 一숀一䜀 䌀䄀伀∀ഀഀ
"[english]GameUI_KeyboardAdvanced_Title"	"KEYBOARD - ADVANCED"਍∀䜀愀洀攀唀䤀开伀瀀琀椀漀渀猀刀攀猀琀愀爀琀刀攀焀甀椀爀攀搀开吀椀琀氀攀∀ऀ∀吀唀„䌀䠀찀丞 ⴀ 䬀䠀?䤞 က丞䜀 䰀ꀀ䤞∀ഀഀ
"[english]GameUI_OptionsRestartRequired_Title"	"OPTIONS - RESTART"਍∀䜀愀洀攀唀䤀开伀瀀琀椀漀渀猀刀攀猀琀愀爀琀开伀䬀䈀甀琀琀漀渀∀ऀ∀䬀栀?椞 ᄀ渞最 氀ꄀ椞 渀最愀礀∀ഀഀ
"[english]GameUI_OptionsRestart_OKButton"	"Restart now"਍∀䜀愀洀攀唀䤀开伀瀀琀椀漀渀猀刀攀猀琀愀爀琀开䌀愀渀挀攀氀䈀甀琀琀漀渀∀ऀ∀䬀栀?椞 ᄀ渞最 氀ꄀ椞 猀愀甀∀ഀഀ
"[english]GameUI_OptionsRestart_CancelButton"	"Restart later"਍∀䜀愀洀攀唀䤀开嘀椀搀攀漀䄀搀瘀愀渀挀攀搀开吀椀琀氀攀∀ऀ∀䠀찀一䠀 ꈀ丞䠀 ⴀ 一숀一䜀 䌀䄀伀∀ഀഀ
"[english]GameUI_VideoAdvanced_Title"	"VIDEO - ADVANCED"਍∀䜀愀洀攀唀䤀开䠀甀搀儀甀椀挀欀䤀渀昀漀∀ऀ∀吀栀渀最 琀椀渀 渀栀愀渀栀∀ഀഀ
"[english]GameUI_HudQuickInfo"	"Quick info"਍∀䜀愀洀攀唀䤀开䠀甀搀儀甀椀挀欀䤀渀昀漀开䤀渀昀漀∀ऀ∀䠀椀윀渞 琀栀渀最 琀椀渀 洀甀 瘀 ᄀꄁ渞 琀爀渀 琀洀 渀最꼀洞∀ഀഀ
"[english]GameUI_HudQuickInfo_Info"	"Show health and ammo info on crosshair"਍∀䜀愀洀攀唀䤀开䠀愀爀搀䐀攀猀挀爀椀瀀琀椀漀渀∀ऀ∀䬀묀„琀栀豈 爀ꔀ琞 洀ꄀ渞栀 洀봀㬞 瘀椀 欀栀 挀愞 戀ꄀ渞 猀봀„琀 栀椀윀甞 焀甀ꌀ„栀ꄀ渁⸀∀ഀഀ
"[english]GameUI_HardDescription"	"Enemies are very tough; your weapons are less effective."਍∀䜀愀洀攀唀䤀开䌀氀漀猀攀䌀愀瀀琀椀漀渀猀开䌀栀攀挀欀戀漀砀∀ऀ∀䠀椀쌀渞 琀栀쬀„挀栀切 琀栀挀栀∀ഀഀ
"[english]GameUI_CloseCaptions_Checkbox"	"Display captions"਍∀䜀愀洀攀唀䤀开吀攀猀琀匀瀀攀愀欀攀爀匀攀琀琀椀渀最猀∀ऀ∀䬀椀쌀洞 琀爀愀 琀栀椀뼀琞 氀관瀞 氀漀愀 渀最漀椀∀ഀഀ
"[english]GameUI_TestSpeakerSettings"	"Test speaker settings"਍∀䜀愀洀攀唀䤀开䔀渀愀戀氀攀搀∀ऀ∀䈀관琞∀ഀഀ
"[english]GameUI_Enabled"	"Enabled"਍∀䜀愀洀攀唀䤀开䐀椀猀愀戀氀攀搀∀ऀ∀吀꼀琞∀ഀഀ
"[english]GameUI_Disabled"	"Disabled"਍∀最愀洀攀甀椀开渀漀爀攀昀氀攀挀琀椀漀渀猀∀ऀ∀倀栀ꌀ渞 挀栀椀뼀甞 ᄀꄁ渁 最椀ꌀ渞∀ഀഀ
"[english]gameui_noreflections"	"Simple reflections"਍∀最愀洀攀甀椀开爀攀昀氀攀挀琀漀渀氀礀眀漀爀氀搀∀ऀ∀倀栀ꌀ渞 挀栀椀뼀甞 琀栀뼀„最椀椞∀ഀഀ
"[english]gameui_reflectonlyworld"	"Reflect world"਍∀最愀洀攀甀椀开爀攀昀氀攀挀琀愀氀氀∀ऀ∀倀栀ꌀ渞 挀栀椀뼀甞 琀ꔀ琞 挀ꌀ∞ഀഀ
"[english]gameui_reflectall"	"Reflect all"਍∀䜀愀洀攀唀䤀开䈀甀最开匀甀挀挀攀猀猀昀甀氀∀ऀ∀က 最椞 琀栀渀最 戀漀 氀휀椞 琀栀渀栀 挀渀最℀∀ഀഀ
"[english]GameUI_Bug_Successful"	"Bug successfully submitted!"਍∀䜀愀洀攀唀䤀开䈀甀最开匀甀戀洀椀琀琀椀渀最∀ऀ∀က愁渀最 最椞 琀栀渀最 戀漀 氀휀椞⸀⸀⸀∀ഀഀ
"[english]GameUI_Bug_Submitting"	"Submitting Bug..."਍∀䜀愀洀攀唀䤀开䈀甀最开吀愀欀攀匀挀爀攀攀渀猀栀漀琀∀ऀ∀䌀栀瀞 洀渀 栀渀栀∀ഀഀ
"[english]GameUI_Bug_TakeScreenshot"	"Take screenshot"਍∀䜀愀洀攀唀䤀开䈀甀最开䌀氀攀愀爀䘀漀爀洀∀ऀ∀堀愀 渀椞 搀甀渀最 洀꬀甞∀ഀഀ
"[english]GameUI_Bug_ClearForm"	"Clear Form"਍∀䜀愀洀攀唀䤀开䈀甀最开吀椀琀氀攀∀ऀ∀䐀愀渀栀 栀椀윀甞㨀∀ഀഀ
"[english]GameUI_Bug_Title"	"Title:"਍∀䜀愀洀攀唀䤀开䈀甀最开䐀攀猀挀爀椀瀀琀椀漀渀∀ऀ∀䴀 琀ꌀ㨞∀ഀഀ
"[english]GameUI_Bug_Description"	"Description:"਍∀䜀愀洀攀唀䤀开䈀甀最开倀漀猀椀琀椀漀渀∀ऀ∀嘀쬀„琀爀㨀∀ഀഀ
"[english]GameUI_Bug_Position"	"Position:"਍∀䜀愀洀攀唀䤀开䈀甀最开䴀愀瀀∀ऀ∀䈀ꌀ渞 ᄀ팁㨞∀ഀഀ
"[english]GameUI_Bug_Map"	"Map:"਍∀䜀愀洀攀唀䤀开䈀甀最开刀攀瀀漀爀琀吀礀瀀攀∀ऀ∀䰀漀ꄀ椞 戀漀 挀漀㨀∀ഀഀ
"[english]GameUI_Bug_ReportType"	"Report type:"਍∀䜀愀洀攀唀䤀开䈀甀最开䔀洀愀椀氀䄀搀搀爀攀猀猀∀ऀ∀က쬁愞 挀栀준„攀洀愀椀氀㨀∀ഀഀ
"[english]GameUI_Bug_EmailAddress"	"Email Address:"਍∀䜀愀洀攀唀䤀开䈀甀最开倀爀椀瘀愀挀礀倀漀氀椀挀礀∀ऀ∀䌀栀渀栀 猀挀栀 戀ꌀ漞 洀관琞 挀愞 嘀愀氀瘀攀∀ഀഀ
"[english]GameUI_Bug_PrivacyPolicy"	"Valve's Privacy Policy"਍∀䜀愀洀攀唀䤀开䈀甀最开伀瀀琀椀漀渀愀氀∀ऀ∀⠀䬀栀渀最 戀꼀琞 戀甀挞⤀∀ഀഀ
"[english]GameUI_Bug_Optional"	"(optional)"਍∀䜀愀洀攀唀䤀开䈀甀最开䄀挀挀漀甀渀琀一愀洀攀∀ऀ∀吀渀 琀椀 欀栀漀ꌀ渞㨀∀ഀഀ
"[english]GameUI_Bug_AccountName"	"Account Name:"਍∀䜀愀洀攀唀䤀开䈀甀最开匀甀戀洀椀琀∀ऀ∀䜀椞∀ഀഀ
"[english]GameUI_Bug_Submit"	"Submit"਍∀䜀愀洀攀唀䤀开䈀甀最开䌀氀攀愀爀䘀椀氀攀猀∀ऀ∀堀愀 琀관瀞 琀椀渀∀ഀഀ
"[english]GameUI_Bug_ClearFiles"	"Clear files"਍∀䜀愀洀攀唀䤀开䈀甀最开䈀匀倀开䘀椀氀攀∀ऀ∀吀윀瀞 ⸀戀猀瀀∀ഀഀ
"[english]GameUI_Bug_BSP_File"	".bsp file"਍∀䜀愀洀攀唀䤀开䈀甀最开嘀䴀䘀开䘀椀氀攀∀ऀ∀吀윀瀞 ⸀瘀洀昀∀ഀഀ
"[english]GameUI_Bug_VMF_File"	".vmf file"਍∀䜀愀洀攀唀䤀开圀愀琀攀爀开䐀攀琀愀椀氀∀ऀ∀䌀栀椀 琀椀뼀琞 渀뀀挞∀ഀഀ
"[english]GameUI_Water_Detail"	"Water detail"਍∀䜀愀洀攀唀䤀开匀栀愀搀漀眀开䐀攀琀愀椀氀∀ऀ∀䌀栀椀 琀椀뼀琞 戀渀最∀ഀഀ
"[english]GameUI_Shadow_Detail"	"Shadow detail"਍∀䜀愀洀攀唀䤀开匀栀愀搀攀爀开䐀攀琀愀椀氀∀ऀ∀䌀栀椀 琀椀뼀琞 ᄀ픁„戀渀最 ⠀匀栀愀搀攀爀⤀∀ഀഀ
"[english]GameUI_Shader_Detail"	"Shader detail"਍∀䜀愀洀攀唀䤀开䌀漀氀漀爀开䌀漀爀爀攀挀琀椀漀渀∀ऀ∀䌀栀준渞栀 洀甀 猀꼀挞∀ഀഀ
"[english]GameUI_Color_Correction"	"Color Correction"਍∀䜀愀洀攀唀䤀开一漀伀瀀琀椀漀渀猀夀攀琀∀ऀ∀㰀 挀栀뀀愁 挀 琀豈礀 挀栀촀渞 㸀∀ഀഀ
"[english]GameUI_NoOptionsYet"	"< no options yet >"਍∀䜀愀洀攀唀䤀开一漀渀攀∀ऀ∀䬀栀渀最∀ഀഀ
"[english]GameUI_None"	"None"਍∀䜀愀洀攀唀䤀开䄀渀椀猀漀琀爀漀瀀椀挀㈀堀∀ऀ∀䄀渀椀猀漀琀爀漀瀀椀挀 ㈀堀∀ഀഀ
"[english]GameUI_Anisotropic2X"	"Anisotropic 2X"਍∀䜀愀洀攀唀䤀开䄀渀椀猀漀琀爀漀瀀椀挀㐀堀∀ऀ∀䄀渀椀猀漀琀爀漀瀀椀挀 㐀堀∀ഀഀ
"[english]GameUI_Anisotropic4X"	"Anisotropic 4X"਍∀䜀愀洀攀唀䤀开䄀渀椀猀漀琀爀漀瀀椀挀㠀堀∀ऀ∀䄀渀椀猀漀琀爀漀瀀椀挀 㠀堀∀ഀഀ
"[english]GameUI_Anisotropic8X"	"Anisotropic 8X"਍∀䜀愀洀攀唀䤀开䄀渀椀猀漀琀爀漀瀀椀挀㄀㘀堀∀ऀ∀䄀渀椀猀漀琀爀漀瀀椀挀 ㄀㘀堀∀ഀഀ
"[english]GameUI_Anisotropic16X"	"Anisotropic 16X"਍∀䜀愀洀攀唀䤀开㈀堀∀ऀ∀㈀砀 䴀匀䄀䄀∀ഀഀ
"[english]GameUI_2X"	"2x MSAA"਍∀䜀愀洀攀唀䤀开㐀堀∀ऀ∀㐀砀 䴀匀䄀䄀∀ഀഀ
"[english]GameUI_4X"	"4x MSAA"਍∀䜀愀洀攀唀䤀开㘀堀∀ऀ∀㘀砀 䴀匀䄀䄀∀ഀഀ
"[english]GameUI_6X"	"6x MSAA"਍∀䜀愀洀攀唀䤀开㠀堀∀ऀ∀㠀砀 䴀匀䄀䄀∀ഀഀ
"[english]GameUI_8X"	"8x MSAA"਍∀䜀愀洀攀唀䤀开㠀堀开䌀匀䄀䄀∀ऀ∀㠀砀 䌀匀䄀䄀∀ഀഀ
"[english]GameUI_8X_CSAA"	"8x CSAA"਍∀䜀愀洀攀唀䤀开㄀㘀堀开䌀匀䄀䄀∀ऀ∀㄀㘀砀 䌀匀䄀䄀∀ഀഀ
"[english]GameUI_16X_CSAA"	"16x CSAA"਍∀䜀愀洀攀唀䤀开㄀㘀堀儀开䌀匀䄀䄀∀ऀ∀㄀㘀砀儀 䌀匀䄀䄀∀ഀഀ
"[english]GameUI_16XQ_CSAA"	"16xQ CSAA"਍∀䜀愀洀攀唀䤀开刀攀挀漀洀洀攀渀搀攀搀匀攀琀琀椀渀最猀∀ऀ∀⨀ 吀栀椀뼀琞 氀관瀞 欀栀甀礀뼀渞 渀最栀쬀„挀栀漀 栀윀„琀栀턀渞最 挀愞 戀ꄀ渞∀ഀഀ
"[english]GameUI_RecommendedSettings"	"* Setting recommended for your system"਍∀䜀愀洀攀唀䤀开栀搀爀开氀攀瘀攀氀　∀ऀ∀䬀栀渀最∀ഀഀ
"[english]GameUI_hdr_level0"	"None"਍∀䜀愀洀攀唀䤀开䴀漀琀椀漀渀䈀氀甀爀∀ऀ∀䰀洀 洀?„挀栀甀礀쌀渞 ᄀ渞最∀ഀഀ
"[english]GameUI_MotionBlur"	"Motion Blur"਍∀䜀愀洀攀唀䤀开䈀攀渀挀栀洀愀爀欀刀攀猀甀氀琀猀开吀椀琀氀攀∀ऀ∀䬀븀吞 儀唀ꈀ„䬀䤀숀䴞 吀刀䄀∀ഀഀ
"[english]GameUI_BenchmarkResults_Title"	"TEST RESULTS"਍∀䜀愀洀攀唀䤀开䐀椀猀瀀氀愀礀吀嘀∀ऀ∀吀椀瘀椀∀ഀഀ
"[english]GameUI_DisplayTV"	"Television"਍∀䜀愀洀攀唀䤀开䐀椀猀瀀氀愀礀䴀漀渀椀琀漀爀∀ऀ∀䴀渀 栀渀栀 洀礀 琀渀栀∀ഀഀ
"[english]GameUI_DisplayMonitor"	"Computer Monitor"਍∀䜀愀洀攀唀䤀开吀攀猀琀匀瀀攀愀欀攀爀猀圀愀爀渀椀渀最开吀椀琀氀攀∀ऀ∀䬀椀쌀洞 琀爀愀 琀栀椀뼀琞 氀관瀞 氀漀愀∀ഀഀ
"[english]GameUI_TestSpeakersWarning_Title"	"Test Speaker Settings"਍∀䜀愀洀攀唀䤀开吀攀猀琀匀瀀攀愀欀攀爀猀圀愀爀渀椀渀最开䌀愀渀挀攀氀䈀甀琀琀漀渀∀ऀ∀䠀礞∀ഀഀ
"[english]GameUI_TestSpeakersWarning_CancelButton"	"Cancel"਍∀䜀愀洀攀唀䤀开匀愀瘀攀䄀渀搀儀甀椀琀∀ऀ∀䰀뀀甁∀ഀഀ
"[english]GameUI_SaveAndQuit"	"Save"਍∀䜀愀洀攀唀䤀开䐀漀渀琀匀愀瘀攀䄀渀搀儀甀椀琀∀ऀ∀䬀栀渀最 氀뀀甁∀ഀഀ
"[english]GameUI_DontSaveAndQuit"	"Don't save"਍∀䜀愀洀攀唀䤀开一漀䌀氀漀猀攀搀䌀愀瀀琀椀漀渀猀∀ऀ∀䬀栀渀最 挀栀切 琀栀挀栀∀ഀഀ
"[english]GameUI_NoClosedCaptions"	"No captions"਍∀䜀愀洀攀唀䤀开匀甀戀琀椀琀氀攀猀∀ऀ∀倀栀„ᄀ섁„⠀挀栀준„栀椞 琀栀漀ꄀ椞⤀∀ऀ嬀␀圀䤀一㌀㈀崀ഀഀ
"[english]GameUI_Subtitles"	"Subtitles (dialog only)"਍∀䜀愀洀攀唀䤀开匀甀戀琀椀琀氀攀猀∀ऀ∀匀甀戀琀椀琀氀攀猀∀ऀ嬀␀堀㌀㘀　崀ഀഀ
"[english]GameUI_Subtitles"	"Subtitles"਍∀䜀愀洀攀唀䤀开匀甀戀琀椀琀氀攀猀䄀渀搀匀漀甀渀搀䔀昀昀攀挀琀猀∀ऀ∀倀栀„ᄀ섁∞ഀഀ
"[english]GameUI_SubtitlesAndSoundEffects"	"Closed Captions"਍∀䜀愀洀攀唀䤀开倀愀甀猀攀搀∀ऀ∀က쌁 一䜀꼀丁䜀∀ഀഀ
"[english]GameUI_Paused"	"PAUSED"਍∀䜀愀洀攀唀䤀开匀瀀爀愀礀开䤀洀瀀漀爀琀开䤀洀愀最攀开圀爀漀渀最开匀椀稀攀∀ऀ∀䠀渀栀 ꌀ渞栀 渀最甀팀渞 欀栀渀最 ?„欀挀栀 挀„挀栀渀栀 砀挀⸀ 䌀栀椀섀甞 挀愀漀 瘀 挀栀椀섀甞 搀椀 ᄀ度渀最 氀 ㈀㔀㘀Ⰰ ㄀㈀㠀Ⰰ 㘀㐀Ⰰ ㌀㈀Ⰰ ㄀㘀Ⰰ 㠀Ⰰ 㐀Ⰰ ㈀Ⰰ 瘀 ㄀⸀∀ഀഀ
"[english]GameUI_Spray_Import_Image_Wrong_Size"	"Source image is not the correct size.  Valid height and width values in pixels are 256, 128, 64, 32, 16, 8, 4, 2, and 1."਍∀䜀愀洀攀唀䤀开匀瀀爀愀礀开䤀洀瀀漀爀琀开䔀爀爀漀爀开䤀洀愀最攀开䘀椀氀攀开䌀漀爀爀甀瀀琀∀ऀ∀吀윀瀞 栀渀栀 ꌀ渞栀 戀쬀„栀케渞最⸀∀ഀഀ
"[english]GameUI_Spray_Import_Error_Image_File_Corrupt"	"Image file is corrupt."਍∀䜀愀洀攀唀䤀开匀瀀爀愀礀开䤀洀瀀漀爀琀开䔀爀爀漀爀开䈀䴀倀开䘀漀爀洀愀琀开一漀琀开匀甀瀀瀀漀爀琀攀搀∀ऀ∀က쬁渞栀 搀ꄀ渞最 䈀䴀倀 挀愞 琀윀瀞 渀礀 欀栀渀最 ᄀ뀁挞 栀휀„琀爀⸞ က쬁渞栀 搀ꄀ渞最 䈀䴀倀 ᄀ뀁挞 栀휀„琀爀„氀 ㈀㐀ⴀ戀椀琀 刀䜀䈀 瘀 ㌀㈀ⴀ戀椀琀 刀䜀䈀䄀⸀∀ഀഀ
"[english]GameUI_Spray_Import_Error_BMP_Format_Not_Supported"	"This file's BMP format is not supported.  Supported BMP formats are 24-bit RGB and 32-bit RGBA."਍∀䜀愀洀攀唀䤀开匀瀀爀愀礀开䤀洀瀀漀爀琀开䔀爀爀漀爀开吀䜀䄀开䘀漀爀洀愀琀开一漀琀开匀甀瀀瀀漀爀琀攀搀∀ऀ∀က쬁渞栀 搀ꄀ渞最 吀䜀䄀 挀愞 琀윀瀞 渀礀 欀栀渀最 ᄀ뀁挞 栀휀„琀爀⸞ က쬁渞栀 搀ꄀ渞最 吀䜀䄀 ᄀ뀁挞 栀휀„琀爀„氀 ㈀㐀ⴀ戀椀琀 刀䜀䈀 瘀 ㌀㈀ⴀ戀椀琀 刀䜀䈀䄀⸀∀ഀഀ
"[english]GameUI_Spray_Import_Error_TGA_Format_Not_Supported"	"This file's TGA format is not supported.  Supported TGA formats are 24-bit RGB and 32-bit RGBA."਍∀䜀愀洀攀唀䤀开匀瀀爀愀礀开䤀洀瀀漀爀琀开䔀爀爀漀爀开圀爀椀琀椀渀最开吀攀洀瀀开伀甀琀瀀甀琀∀ऀ∀䰀휀椞 琀ꄀ漞 琀윀瀞 琀ꄀ洞 琀栀?椞⸀∀ഀഀ
"[english]GameUI_Spray_Import_Error_Writing_Temp_Output"	"Error creating temporary file."਍∀䜀愀洀攀唀䤀开䄀氀氀开䤀洀愀最攀猀∀ऀ∀吀ꔀ琞 挀ꌀ„栀渀栀 ꌀ渞栀 ⠀⨀⸀樀瀀最Ⰰ⨀⸀戀洀瀀Ⰰ⨀⸀琀最愀Ⰰ⨀⸀瘀琀昀⤀∀ഀഀ
"[english]GameUI_All_Images"	"All Images (*.jpg,*.bmp,*.tga,*.vtf)"਍∀䜀愀洀攀唀䤀开匀攀琀琀椀渀最䌀栀愀渀最攀䘀爀漀洀堀㌀㘀　䐀愀猀栀戀漀愀爀搀开吀椀琀氀攀∀ऀ∀吀夀 䌀䠀찀丞∀ഀഀ
"[english]GameUI_SettingChangeFromX360Dashboard_Title"	"OPTIONS"਍∀䜀愀洀攀唀䤀开䌀栀愀瀀琀攀爀∀ऀ∀䌀䠀꼀ꀁ丁䜀∀ഀഀ
"[english]GameUI_Chapter"	"CHAPTER"਍∀嘀䄀䌀开䰀漀最最攀搀䤀渀䔀氀猀攀眀栀攀爀攀刀攀愀猀漀渀∀ऀ∀吀椀 欀栀漀ꌀ渞 匀琀攀愀洀 渀礀 ᄀ愁渀最 ᄀ뀁挞 猀„搀渞最 琀爀渀 洀琞 洀礀 欀栀挀⸀ က쌁„琀椀뼀瀞 琀挞 猀„搀渞最 匀琀攀愀洀Ⰰ 戀ꄀ渞 挀꜀渞 ᄀ́渁最 渀栀관瀞 氀ꄀ椞⸀∀ഀഀ
"[english]VAC_LoggedInElsewhereReason"	"This Steam account has been used to log in from another computer. To continue using Steam, you need to log in again."਍∀䜀䄀䴀䔀唀䤀开䌀漀洀洀攀渀琀愀爀礀开伀昀昀∀ऀ∀吀꼀琞∀ഀഀ
"[english]GAMEUI_Commentary_Off"	"Off"਍∀䜀䄀䴀䔀唀䤀开䌀漀洀洀攀渀琀愀爀礀开䰀愀戀攀氀伀渀∀ऀ∀䌀䠀쐀„က„䈀찀一䠀 䰀唀가丞 က䄁一䜀㨀 䈀가吞∀ഀഀ
"[english]GAMEUI_Commentary_LabelOn"	"COMMENTARY MODE IS CURRENTLY: ON"਍∀䜀䄀䴀䔀唀䤀开䌀漀洀洀攀渀琀愀爀礀开䰀愀戀攀氀伀昀昀∀ऀ∀䌀䠀븀„က„䈀찀一䠀 䰀唀가丞 က䄁一䜀㨀 吀글吞∀ഀഀ
"[english]GAMEUI_Commentary_LabelOff"	"COMMENTARY MODE IS CURRENTLY: OFF"਍∀䜀䄀䴀䔀唀䤀开倀漀猀琀䌀漀洀洀攀渀琀愀爀礀开䴀漀搀攀䰀愀戀攀氀伀渀∀ऀ∀က쌁 䈀가吞 䌀䠀븀„က„䈀찀一䠀 䰀唀가丞∀ഀഀ
"[english]GAMEUI_PostCommentary_ModeLabelOn"	"COMMENTARY MODE IS: ON"਍∀䜀䄀䴀䔀唀䤀开倀漀猀琀䌀漀洀洀攀渀琀愀爀礀开䴀漀搀攀䰀愀戀攀氀伀昀昀∀ऀ∀က쌁 吀글吞 䌀䠀븀„က„䈀찀一䠀 䰀唀가丞∀ഀഀ
"[english]GAMEUI_PostCommentary_ModeLabelOff"	"COMMENTARY MODE IS: OFF"਍∀䜀愀洀攀唀䤀开䌀栀愀渀最攀䰀愀渀最甀愀最攀刀攀猀琀愀爀琀开䌀愀渀挀攀氀䈀甀琀琀漀渀∀ऀ∀䠀礞∀ഀഀ
"[english]GameUI_ChangeLanguageRestart_CancelButton"	"Cancel"਍∀䜀愀洀攀唀䤀开䈀开䈀唀吀吀伀一∀ऀ∀一切琀 䈀∀ഀഀ
"[english]GameUI_B_BUTTON"	"B Button"਍∀䜀愀洀攀唀䤀开堀开䈀唀吀吀伀一∀ऀ∀一切琀 堀∀ഀഀ
"[english]GameUI_X_BUTTON"	"X Button"਍∀䜀愀洀攀唀䤀开夀开䈀唀吀吀伀一∀ऀ∀一切琀 夀∀ഀഀ
"[english]GameUI_Y_BUTTON"	"Y Button"਍∀䜀愀洀攀唀䤀开䰀开吀刀䤀䜀䜀䔀刀∀ऀ∀䌀 琀爀椀 ⠀䰀吀⤀∀ഀഀ
"[english]GameUI_L_TRIGGER"	"Left Trigger"਍∀䜀愀洀攀唀䤀开刀开吀刀䤀䜀䜀䔀刀∀ऀ∀䌀 瀀栀ꌀ椞 ⠀刀吀⤀∀ഀഀ
"[english]GameUI_R_TRIGGER"	"Right Trigger"਍∀䜀愀洀攀唀䤀开䰀开匀䠀伀唀䰀䐀䔀刀∀ऀ∀က윁洞 琀爀椀∀ഀഀ
"[english]GameUI_L_SHOULDER"	"Left Shoulder"਍∀䜀愀洀攀唀䤀开刀开匀䠀伀唀䰀䐀䔀刀∀ऀ∀က윁洞 瀀栀ꌀ椞∀ഀഀ
"[english]GameUI_R_SHOULDER"	"Right Shoulder"਍∀䜀愀洀攀唀䤀开䤀挀漀渀猀开唀倀∀ऀ∀唀∀ഀഀ
"[english]GameUI_Icons_UP"	"U"਍∀䜀愀洀攀唀䤀开䤀挀漀渀猀开䐀伀圀一∀ऀ∀䐀∀ഀഀ
"[english]GameUI_Icons_DOWN"	"D"਍∀䜀愀洀攀唀䤀开䤀挀漀渀猀开䰀䔀䘀吀∀ऀ∀䰀∀ഀഀ
"[english]GameUI_Icons_LEFT"	"L"਍∀䜀愀洀攀唀䤀开䤀挀漀渀猀开刀䤀䜀䠀吀∀ऀ∀刀∀ഀഀ
"[english]GameUI_Icons_RIGHT"	"R"਍∀䜀愀洀攀唀䤀开䤀挀漀渀猀开䐀倀䄀䐀∀ऀ∀䌀∀ഀഀ
"[english]GameUI_Icons_DPAD"	"C"਍∀䜀愀洀攀唀䤀开䤀挀漀渀猀开匀吀䄀刀吀∀ऀ∀㔀∀ഀഀ
"[english]GameUI_Icons_START"	"5"਍∀䜀愀洀攀唀䤀开䤀挀漀渀猀开匀吀䤀䌀䬀㄀∀ऀ∀㘀∀ഀഀ
"[english]GameUI_Icons_STICK1"	"6"਍∀䜀愀洀攀唀䤀开䤀挀漀渀猀开匀吀䤀䌀䬀㈀∀ऀ∀㜀∀ഀഀ
"[english]GameUI_Icons_STICK2"	"7"਍∀䜀愀洀攀唀䤀开䤀挀漀渀猀开匀㄀开唀倀∀ऀ∀㘀∀ഀഀ
"[english]GameUI_Icons_S1_UP"	"6"਍∀䜀愀洀攀唀䤀开䤀挀漀渀猀开匀㈀开唀倀∀ऀ∀㜀∀ഀഀ
"[english]GameUI_Icons_S2_UP"	"7"਍∀䜀愀洀攀唀䤀开䤀挀漀渀猀开䰀匀吀䤀䌀䬀∀ऀ∀㘀∀ഀഀ
"[english]GameUI_Icons_LSTICK"	"6"਍∀䜀愀洀攀唀䤀开䤀挀漀渀猀开刀匀吀䤀䌀䬀∀ऀ∀㜀∀ഀഀ
"[english]GameUI_Icons_RSTICK"	"7"਍∀䜀愀洀攀唀䤀开䤀挀漀渀猀开䄀开䈀唀吀吀伀一∀ऀ∀䄀∀ഀഀ
"[english]GameUI_Icons_A_BUTTON"	"A"਍∀䜀愀洀攀唀䤀开䤀挀漀渀猀开䈀开䈀唀吀吀伀一∀ऀ∀䈀∀ഀഀ
"[english]GameUI_Icons_B_BUTTON"	"B"਍∀䜀愀洀攀唀䤀开䤀挀漀渀猀开堀开䈀唀吀吀伀一∀ऀ∀堀∀ഀഀ
"[english]GameUI_Icons_X_BUTTON"	"X"਍∀䜀愀洀攀唀䤀开䤀挀漀渀猀开夀开䈀唀吀吀伀一∀ऀ∀夀∀ഀഀ
"[english]GameUI_Icons_Y_BUTTON"	"Y"਍∀䜀愀洀攀唀䤀开䤀挀漀渀猀开䰀开匀䠀伀唀䰀䐀䔀刀∀ऀ∀㈀∀ഀഀ
"[english]GameUI_Icons_L_SHOULDER"	"2"਍∀䜀愀洀攀唀䤀开䤀挀漀渀猀开刀开匀䠀伀唀䰀䐀䔀刀∀ऀ∀㌀∀ഀഀ
"[english]GameUI_Icons_R_SHOULDER"	"3"਍∀䜀愀洀攀唀䤀开䤀挀漀渀猀开䰀开吀刀䤀䜀䜀䔀刀∀ऀ∀　∀ഀഀ
"[english]GameUI_Icons_L_TRIGGER"	"0"਍∀䜀愀洀攀唀䤀开䤀挀漀渀猀开刀开吀刀䤀䜀䜀䔀刀∀ऀ∀㄀∀ഀഀ
"[english]GameUI_Icons_R_TRIGGER"	"1"਍∀䜀愀洀攀唀䤀开䤀挀漀渀猀开䰀䔀䘀吀䌀唀刀匀伀刀∀ऀ∀㠀∀ഀഀ
"[english]GameUI_Icons_LEFTCURSOR"	"8"਍∀䜀愀洀攀唀䤀开䤀挀漀渀猀开刀䤀䜀䠀吀䌀唀刀匀伀刀∀ऀ∀㤀∀ഀഀ
"[english]GameUI_Icons_RIGHTCURSOR"	"9"਍∀䜀愀洀攀唀䤀开䤀挀漀渀猀开唀倀䌀唀刀匀伀刀∀ऀ∀㰀∀ഀഀ
"[english]GameUI_Icons_UPCURSOR"	"<"਍∀䜀愀洀攀唀䤀开䤀挀漀渀猀开䐀伀圀一䌀唀刀匀伀刀∀ऀ∀㸀∀ഀഀ
"[english]GameUI_Icons_DOWNCURSOR"	">"਍∀䜀愀洀攀唀䤀开䤀挀漀渀猀开一伀一䔀∀ऀ∀㰀 挀栀뀀愁 琀栀椀뼀琞 氀관瀞 㸀∀ഀഀ
"[english]GameUI_Icons_NONE"	"< not assigned >"਍∀䜀愀洀攀唀䤀开䬀攀礀一愀洀攀猀开唀倀∀ऀ∀䐀ⴀ瀀愀搀 氀渀∀ഀഀ
"[english]GameUI_KeyNames_UP"	"D-pad up"਍∀䜀愀洀攀唀䤀开䬀攀礀一愀洀攀猀开䐀伀圀一∀ऀ∀䐀ⴀ瀀愀搀 砀甀턀渞最∀ഀഀ
"[english]GameUI_KeyNames_DOWN"	"D-pad down"਍∀䜀愀洀攀唀䤀开䬀攀礀一愀洀攀猀开䰀䔀䘀吀∀ऀ∀䐀ⴀ瀀愀搀 琀爀椀∀ഀഀ
"[english]GameUI_KeyNames_LEFT"	"D-pad left"਍∀䜀愀洀攀唀䤀开䬀攀礀一愀洀攀猀开刀䤀䜀䠀吀∀ऀ∀䐀ⴀ瀀愀搀 瀀栀ꌀ椞∀ഀഀ
"[english]GameUI_KeyNames_RIGHT"	"D-pad right"਍∀䜀愀洀攀唀䤀开䬀攀礀一愀洀攀猀开匀吀䤀䌀䬀㄀∀ऀ∀渀切琀 挀꜀渞 琀爀케„琀爀椀∀ഀഀ
"[english]GameUI_KeyNames_STICK1"	"left stick button"਍∀䜀愀洀攀唀䤀开䬀攀礀一愀洀攀猀开匀吀䤀䌀䬀㈀∀ऀ∀渀切琀 挀꜀渞 琀爀케„瀀栀ꌀ椞∀ഀഀ
"[english]GameUI_KeyNames_STICK2"	"right stick button"਍∀䜀愀洀攀唀䤀开䬀攀礀一愀洀攀猀开匀㄀开唀倀∀ऀ∀挀꜀渞 琀爀케„琀爀椀 ⠀䰀匀⤀∀ഀഀ
"[english]GameUI_KeyNames_S1_UP"	"left stick"਍∀䜀愀洀攀唀䤀开䬀攀礀一愀洀攀猀开匀㈀开唀倀∀ऀ∀挀 瀀栀ꌀ椞 ⠀刀匀⤀∀ഀഀ
"[english]GameUI_KeyNames_S2_UP"	"right stick"਍∀䜀愀洀攀唀䤀开䬀攀礀一愀洀攀猀开䰀匀吀䤀䌀䬀∀ऀ∀挀꜀渞 琀爀케„琀爀椀 ⠀䰀匀⤀∀ഀഀ
"[english]GameUI_KeyNames_LSTICK"	"left stick"਍∀䜀愀洀攀唀䤀开䬀攀礀一愀洀攀猀开刀匀吀䤀䌀䬀∀ऀ∀挀 瀀栀ꌀ椞 ⠀刀匀⤀∀ഀഀ
"[english]GameUI_KeyNames_RSTICK"	"right stick"਍∀䜀愀洀攀唀䤀开䬀攀礀一愀洀攀猀开䄀开䈀唀吀吀伀一∀ऀ∀一切琀 䄀∀ഀഀ
"[english]GameUI_KeyNames_A_BUTTON"	"A button"਍∀䜀愀洀攀唀䤀开䬀攀礀一愀洀攀猀开䈀开䈀唀吀吀伀一∀ऀ∀一切琀 䈀∀ഀഀ
"[english]GameUI_KeyNames_B_BUTTON"	"B button"਍∀䜀愀洀攀唀䤀开䬀攀礀一愀洀攀猀开堀开䈀唀吀吀伀一∀ऀ∀一切琀 堀∀ഀഀ
"[english]GameUI_KeyNames_X_BUTTON"	"X button"਍∀䜀愀洀攀唀䤀开䬀攀礀一愀洀攀猀开夀开䈀唀吀吀伀一∀ऀ∀一切琀 夀∀ഀഀ
"[english]GameUI_KeyNames_Y_BUTTON"	"Y button"਍∀䜀愀洀攀唀䤀开䬀攀礀一愀洀攀猀开䰀开匀䠀伀唀䰀䐀䔀刀∀ऀ∀ᄀ윁洞 琀爀椀∀ഀഀ
"[english]GameUI_KeyNames_L_SHOULDER"	"left bumper"਍∀䜀愀洀攀唀䤀开䬀攀礀一愀洀攀猀开刀开匀䠀伀唀䰀䐀䔀刀∀ऀ∀ᄀ윁洞 瀀栀ꌀ椞∀ഀഀ
"[english]GameUI_KeyNames_R_SHOULDER"	"right bumper"਍∀䜀愀洀攀唀䤀开䬀攀礀一愀洀攀猀开䰀开吀刀䤀䜀䜀䔀刀∀ऀ∀挀 琀爀椀 ⠀䰀吀⤀∀ഀഀ
"[english]GameUI_KeyNames_L_TRIGGER"	"left trigger"਍∀䜀愀洀攀唀䤀开䬀攀礀一愀洀攀猀开刀开吀刀䤀䜀䜀䔀刀∀ऀ∀挀 瀀栀ꌀ椞 ⠀刀吀⤀∀ഀഀ
"[english]GameUI_KeyNames_R_TRIGGER"	"right trigger"਍∀䜀愀洀攀唀䤀开䜀愀洀攀∀ऀ∀䜀䄀䴀䔀∀ऀ嬀␀堀㌀㘀　崀ഀഀ
"[english]GameUI_Game"	"GAME"਍∀䜀愀洀攀唀䤀开䈀甀琀琀漀渀猀∀ऀ∀一吀∀ഀഀ
"[english]GameUI_Buttons"	"BUTTONS"਍∀䜀愀洀攀唀䤀开刀攀猀琀漀爀攀䐀攀昀愀甀氀琀猀∀ऀ∀䬀䠀퐀䤀 倀䠀䌞 䴀똀䌞 က쨁丞䠀∀ഀഀ
"[english]GameUI_RestoreDefaults"	"RESTORE DEFAULTS"਍∀䜀愀洀攀唀䤀开䄀挀挀攀瀀琀∀ऀ∀䌀栀ꔀ瀞 渀栀관渞∀ഀഀ
"[english]GameUI_Accept"	"Accept"਍∀䜀愀洀攀唀䤀开匀攀氀攀挀琀∀ऀ∀䌀栀촀渞∀ഀഀ
"[english]GameUI_Select"	"Select"਍∀䜀愀洀攀唀䤀开刀攀昀爀攀猀栀∀ऀ∀䰀洀 洀椞∀ഀഀ
"[english]GameUI_Refresh"	"Refresh"਍∀䜀愀洀攀唀䤀开䔀砀椀琀䰀漀戀戀礀∀ऀ∀吀栀漀琀∀ഀഀ
"[english]GameUI_ExitLobby"	"Exit"਍∀䜀愀洀攀唀䤀开䌀栀愀渀最攀吀攀愀洀∀ऀ∀吀栀愀礀 ᄀ픁椞 က椞∀ഀഀ
"[english]GameUI_ChangeTeam"	"Change Team"਍∀䜀愀洀攀唀䤀开匀琀愀爀琀䜀愀洀攀∀ऀ∀䈀꼀琞 ᄀ꜁甞 挀栀ꄀ椁∀ഀഀ
"[english]GameUI_StartGame"	"Start Game"਍∀䜀愀洀攀唀䤀开夀攀猀∀ऀ∀က팁渞最 ﴀ∀ഀഀ
"[english]GameUI_Yes"	"Yes"਍∀䜀愀洀攀唀䤀开一漀∀ऀ∀䬀栀渀最∀ഀഀ
"[english]GameUI_No"	"No"਍∀䜀愀洀攀唀䤀开䌀漀渀猀漀氀攀开儀甀椀琀圀愀爀渀椀渀最∀ऀ∀䈀ꄀ渞 挀 挀栀꼀挞 洀甀턀渞 琀栀漀琀㼀尀渀䴀촀椞 琀椀뼀渞 琀爀渀栀 挀栀뀀愁 氀뀀甁 猀봀„戀쬀„洀ꔀ琞⸀∀ഀഀ
"[english]GameUI_Console_QuitWarning"	"Are you sure you want to quit?\nAll unsaved progress will be lost."਍∀䜀愀洀攀唀䤀开䌀漀渀猀漀氀攀开匀琀漀爀愀最攀刀攀洀漀瘀攀搀䈀漀搀礀∀ऀ∀䈀ꄀ渞 猀봀„欀栀渀最 琀栀쌀„氀뀀甁 琀椀뼀渞 琀爀渀栀 琀爀 挀栀ꄀ椁 挀愞 洀渀栀 渀뼀甞 欀栀渀最 挀 琀栀椀뼀琞 戀쬀„氀뀀甁 琀爀⸞ 䈀ꄀ渞 挀 洀甀턀渞 挀栀촀渞 琀栀椀뼀琞 戀쬀„氀뀀甁 琀爀„欀栀挀 欀栀渀最㼀∀ഀഀ
"[english]GameUI_Console_StorageRemovedBody"	"You will not be able to save your progress without a storage device. Would you like to select another storage device?"਍∀䜀愀洀攀唀䤀开䄀挀栀椀攀瘀攀洀攀渀琀开倀爀漀最爀攀猀猀开䘀洀琀∀ऀ∀─猀㄀ ⠀─猀㈀⼀─猀㌀⤀∀ഀഀ
"[english]GameUI_Achievement_Progress_Fmt"	"%s1 (%s2/%s3)"਍∀䜀愀洀攀唀䤀开䄀挀栀椀攀瘀攀洀攀渀琀开䰀漀挀欀攀搀∀ऀ∀က 欀栀愀∀ഀഀ
"[english]GameUI_Achievement_Locked"	"Locked"਍∀䜀愀洀攀唀䤀开䄀挀栀椀攀瘀攀洀攀渀琀开唀渀氀漀挀欀攀搀∀ऀ∀က 洀?„欀栀愀∀ഀഀ
"[english]GameUI_Achievement_Unlocked"	"Unlocked"਍∀䜀愀洀攀唀䤀开䄀挀栀椀攀瘀攀洀攀渀琀开倀漀椀渀琀猀∀ऀ∀─猀㄀䜀∀ഀഀ
"[english]GameUI_Achievement_Points"	"%s1G"਍∀䜀愀洀攀唀䤀开䄀挀栀椀攀瘀攀洀攀渀琀开䴀攀渀甀开刀愀渀最攀∀ऀ∀─猀㄀ 琀爀漀渀最 ─猀㈀∀ഀഀ
"[english]GameUI_Achievement_Menu_Range"	"%s1 of %s2"਍∀䜀愀洀攀唀䤀开䌀漀渀猀漀氀攀开唀猀攀爀匀攀琀琀椀渀最猀∀ऀ∀吀栀椀뼀琞 氀관瀞 渀最뀀?椞 搀豈渀最∀ഀഀ
"[english]GameUI_Console_UserSettings"	"User Settings"਍∀䠀䰀堀开䬀䤀䰀䰀开䔀一䔀䴀䤀䔀匀开圀䤀吀䠀倀䠀夀匀䤀䌀匀开一䄀䴀䔀∀ऀ∀䴀礀 渀最栀椀섀渞 砀뀀ꄁ渁最∀ഀഀ
"[english]HLX_KILL_ENEMIES_WITHPHYSICS_NAME"	"Bone Breaker"਍∀䠀䰀堀开䬀䤀䰀䰀开䔀一䔀䴀䤀䔀匀开圀䤀吀䠀倀䠀夀匀䤀䌀匀开䐀䔀匀䌀∀ऀ∀吀椀甀 搀椀윀琞 ㌀　 ᄀ턁椞 瀀栀뀀ꄁ渁最 戀넀渞最 挀挀栀 渀洀 挀挀 瘀관琞 琀栀쌀⸞∀ഀഀ
"[english]HLX_KILL_ENEMIES_WITHPHYSICS_DESC"	"Kill 30 enemies with thrown physics objects."਍∀䠀䰀堀开䬀䤀䰀䰀开䔀一䔀䴀夀开圀䤀吀䠀䠀伀倀倀䔀刀䴀䤀一䔀开一䄀䴀䔀∀ऀ∀吀栀甀 栀漀ꄀ挞栀 挀栀뼀琞 渀最뀀?椞∀ഀഀ
"[english]HLX_KILL_ENEMY_WITHHOPPERMINE_NAME"	"Deadly Harvest"਍∀䠀䰀堀开䬀䤀䰀䰀开䔀一䔀䴀夀开圀䤀吀䠀䠀伀倀倀䔀刀䴀䤀一䔀开䐀䔀匀䌀∀ऀ∀吀椀甀 搀椀윀琞 洀琞 焀甀渀 ᄀ쬁挞栀 戀넀渞最 挀挀栀 ᄀ뜁琞 洀渀 戀愀 挀栀渀⸀∀ഀഀ
"[english]HLX_KILL_ENEMY_WITHHOPPERMINE_DESC"	"Kill an enemy by planting a hopper mine."਍∀䠀䰀堀开䬀䤀䰀䰀开䔀一䔀䴀䤀䔀匀开圀䤀吀䠀䴀䄀一䠀䄀䌀䬀开䐀䔀匀䌀∀ऀ∀吀椀甀 搀椀윀琞 戀턀渞 ᄀ턁椞 瀀栀뀀ꄁ渁最 戀넀渞最 䴀愀渀栀愀挀欀⸀∀ഀഀ
"[english]HLX_KILL_ENEMIES_WITHMANHACK_DESC"	"Kill five enemies with a Manhack."਍∀䠀䰀堀开䬀䤀䰀䰀开匀伀䰀䐀䤀䔀刀开圀䤀吀䠀䠀䤀匀䜀刀䔀一䄀䐀䔀开一䄀䴀䔀∀ऀ∀䬀栀漀愀椀 渀渀最 戀愀渀栀 砀挀∀ഀഀ
"[english]HLX_KILL_SOLDIER_WITHHISGRENADE_NAME"	"Hot Potat0wned"਍∀䠀䰀堀开䬀䤀䰀䰀开匀伀䰀䐀䤀䔀刀开圀䤀吀䠀䠀䤀匀䜀刀䔀一䄀䐀䔀开䐀䔀匀䌀∀ऀ∀䜀椀뼀琞 洀琞 䌀漀洀戀椀渀攀 猀漀氀搀椀攀爀 瘀椞 挀栀渀栀 氀甞 ᄀꄁ渞 挀愞 栀꼀渞⸀∀ഀഀ
"[english]HLX_KILL_SOLDIER_WITHHISGRENADE_DESC"	"Kill a Combine soldier with his own grenade."਍∀䠀䰀堀开䬀䤀䰀䰀开䔀一䔀䴀䤀䔀匀开圀䤀吀䠀伀一䔀䔀一䔀刀䜀夀䈀䄀䰀䰀开一䄀䴀䔀∀ऀ∀一栀 戀ꌀ漞 瘀윀„洀椀 琀爀뀀?渞最∀ഀഀ
"[english]HLX_KILL_ENEMIES_WITHONEENERGYBALL_NAME"	"Conservationist"਍∀䠀䰀堀开䬀䤀䰀䰀开䔀一䔀䴀䤀䔀匀开圀䤀吀䠀伀一䔀䔀一䔀刀䜀夀䈀䄀䰀䰀开䐀䔀匀䌀∀ऀ∀吀椀甀 搀椀윀琞 渀̀洁 欀묀„ᄀ쬁挞栀 挀栀준„戀넀渞最 洀琞 焀甀ꌀ„挀꜀甞 渀̀渁最 氀뀀渞最⸀∀ഀഀ
"[english]HLX_KILL_ENEMIES_WITHONEENERGYBALL_DESC"	"Kill five enemies with the same energy ball."਍∀䜀愀洀攀唀䤀开䰀愀渀最甀愀最攀开䔀渀最氀椀猀栀∀ऀ∀吀椀뼀渞最 䄀渀栀∀ഀഀ
"[english]GameUI_Language_English"	"English"਍∀䜀愀洀攀唀䤀开䰀愀渀最甀愀最攀开䜀攀爀洀愀渀∀ऀ∀吀椀뼀渞最 က挞∀ഀഀ
"[english]GameUI_Language_German"	"German"਍∀䜀愀洀攀唀䤀开䰀愀渀最甀愀最攀开䘀爀攀渀挀栀∀ऀ∀吀椀뼀渞最 倀栀瀀∀ഀഀ
"[english]GameUI_Language_French"	"French"਍∀䜀愀洀攀唀䤀开䰀愀渀最甀愀最攀开䤀琀愀氀椀愀渀∀ऀ∀吀椀뼀渞最 ?∀ഀഀ
"[english]GameUI_Language_Italian"	"Italian"਍∀䜀愀洀攀唀䤀开䰀愀渀最甀愀最攀开䬀漀爀攀愀渀∀ऀ∀吀椀뼀渞最 䠀渀∀ഀഀ
"[english]GameUI_Language_Korean"	"Korean"਍∀䜀愀洀攀唀䤀开䰀愀渀最甀愀最攀开匀瀀愀渀椀猀栀∀ऀ∀吀椀뼀渞最 吀礀 䈀愀渀 一栀愀∀ഀഀ
"[english]GameUI_Language_Spanish"	"Spanish"਍∀䜀愀洀攀唀䤀开䰀愀渀最甀愀最攀开匀椀洀瀀氀椀昀椀攀搀开䌀栀椀渀攀猀攀∀ऀ∀吀椀뼀渞最 吀爀甀渀最 最椀ꌀ渞 琀栀쌀∞ഀഀ
"[english]GameUI_Language_Simplified_Chinese"	"Simplified_Chinese"਍∀䜀愀洀攀唀䤀开䰀愀渀最甀愀最攀开吀爀愀搀椀琀椀漀渀愀氀开䌀栀椀渀攀猀攀∀ऀ∀吀椀뼀渞最 吀爀甀渀最 瀀栀팀渞 琀栀쌀∞ഀഀ
"[english]GameUI_Language_Traditional_Chinese"	"Traditional_Chinese"਍∀䜀愀洀攀唀䤀开䰀愀渀最甀愀最攀开刀甀猀猀椀愀渀∀ऀ∀吀椀뼀渞最 一最愀∀ഀഀ
"[english]GameUI_Language_Russian"	"Russian"਍∀䜀愀洀攀唀䤀开䰀愀渀最甀愀最攀开吀栀愀椀∀ऀ∀吀椀뼀渞最 吀栀椀∀ഀഀ
"[english]GameUI_Language_Thai"	"Thai"਍∀䜀愀洀攀唀䤀开䰀愀渀最甀愀最攀开䨀愀瀀愀渀攀猀攀∀ऀ∀吀椀뼀渞最 一栀관琞∀ഀഀ
"[english]GameUI_Language_Japanese"	"Japanese"਍∀䜀愀洀攀唀䤀开䰀愀渀最甀愀最攀开倀漀爀琀甀最甀攀猀攀∀ऀ∀吀椀뼀渞最 䈀팀„က漀 一栀愀∀ഀഀ
"[english]GameUI_Language_Portuguese"	"Portuguese"਍∀䜀愀洀攀唀䤀开䰀愀渀最甀愀最攀开倀漀氀椀猀栀∀ऀ∀吀椀뼀渞最 䈀愀 䰀愀渀∀ഀഀ
"[english]GameUI_Language_Polish"	"Polish"਍∀䜀愀洀攀唀䤀开䰀愀渀最甀愀最攀开䐀愀渀椀猀栀∀ऀ∀吀椀뼀渞最 က愁渀 䴀ꄀ挞栀∀ഀഀ
"[english]GameUI_Language_Danish"	"Danish"਍∀䜀愀洀攀唀䤀开䰀愀渀最甀愀最攀开䐀甀琀挀栀∀ऀ∀吀椀뼀渞最 䠀 䰀愀渀∀ഀഀ
"[english]GameUI_Language_Dutch"	"Dutch"਍∀䜀愀洀攀唀䤀开䰀愀渀最甀愀最攀开䘀椀渀渀椀猀栀∀ऀ∀吀椀뼀渞最 倀栀꜀渞 䰀愀渀∀ഀഀ
"[english]GameUI_Language_Finnish"	"Finnish"਍∀䜀愀洀攀唀䤀开䰀愀渀最甀愀最攀开一漀爀眀攀最椀愀渀∀ऀ∀吀椀뼀渞最 一愀 唀礀∀ഀഀ
"[english]GameUI_Language_Norwegian"	"Norwegian"਍∀䜀愀洀攀唀䤀开䰀愀渀最甀愀最攀开匀眀攀搀椀猀栀∀ऀ∀吀椀뼀渞最 吀栀礞 က椁쌀渞∀ഀഀ
"[english]GameUI_Language_Swedish"	"Swedish"਍∀䜀愀洀攀唀䤀开䰀漀愀搀䐀椀愀氀漀最开匀攀挀∀ऀ∀─猀㄀ 最椀礀∀ഀഀ
"[english]GameUI_LoadDialog_Sec"	"%s1 seconds"਍∀䜀愀洀攀唀䤀开䌀甀猀琀漀洀吀愀戀开䔀砀瀀氀愀渀愀琀椀漀渀㈀∀ऀ∀䴀礀 挀栀„ᄀ뀁挞 氀椀윀琞 欀 ?„ᄀ礀 ᄀ ᄀ뀁挞 ᄀ椁섀甞 挀栀준渞栀 戀?椞 琀栀渀栀 瘀椀渀 挀渞最 ᄀ팁渞最 ᄀ쌁„琀栀愀礀 ᄀ픁椞 琀爀ꌀ椞 渀最栀椀윀洞 琀爀 挀栀ꄀ椁⸀ 吀栀„渀栀ꔀ瀞 挀栀甀琞 瘀漀 吀栀愀渀栀 琀豈礀 挀栀촀渞 渀뼀甞 戀ꄀ渞 洀甀턀渞 挀栀ꄀ椁 瀀栀椀渀 戀ꌀ渞 ᄀ ᄀ뀁挞 ᄀ椁섀甞 挀栀준渞栀 挀愞 ─最愀洀攀─⸀∀ഀഀ
"[english]GameUI_CustomTab_Explanation2"	"Servers listed there have been modified by members of the community to change the default game experience. Try clicking the custom tab if you want to play modified versions of %game%."਍∀䜀愀洀攀唀䤀开䠀愀瀀琀椀挀猀开䰀漀眀∀ऀ∀吀栀ꔀ瀞∀ഀഀ
"[english]GameUI_Haptics_Low"	"Low"਍∀䜀愀洀攀唀䤀开䠀愀瀀琀椀挀猀开䠀椀最栀∀ऀ∀䌀愀漀∀ഀഀ
"[english]GameUI_Haptics_High"	"High"਍∀䜀愀洀攀唀䤀开䠀愀瀀琀椀挀猀开吀甀爀渀椀渀最∀ऀ∀က„渀栀ꄀ礞 砀漀愀礀 洀渀栀∀ഀഀ
"[english]GameUI_Haptics_Turning"	"Turn Sensitivity"਍∀䜀愀洀攀唀䤀开䠀愀瀀琀椀挀猀开䄀椀洀椀渀最∀ऀ∀က„渀栀ꄀ礞 渀最꼀洞 戀꼀渞∀ഀഀ
"[english]GameUI_Haptics_Aiming"	"Aim Sensitivity"਍∀䜀愀洀攀唀䤀开一漀匀琀攀愀洀匀琀愀琀猀吀爀愀挀欀椀渀最∀ऀ∀夀甀 挀꜀甞 欀뼀琞 渀턀椞 琀椞 匀琀攀愀洀 ᄀ쌁„琀栀攀漀 搀椀 琀栀渀最 琀椀渀 挀愞 戀ꄀ渞⸀尀渀䬀栀椀 欀뼀琞 渀턀椞 ᄀ뀁挞 琀栀挞 栀椀윀渞 戀ꄀ渞 猀봀„ᄀ뀁挞 琀栀渀最 戀漀⸀∀ഀഀ
"[english]GameUI_NoSteamStatsTracking"	"A connection to Steam is required in order to track your statistics.\nOnce a connection has been established you will be notified."਍∀䜀愀洀攀唀䤀开匀琀攀愀洀匀琀愀琀猀一漀眀吀爀愀挀欀椀渀最∀ऀ∀က 琀栀椀뼀琞 氀관瀞 欀뼀琞 渀턀椞 ᄀ뼁渞 匀琀攀愀洀 瘀 猀턀„氀椀윀甞 挀愞 戀ꄀ渞 猀봀„ᄀ뀁挞 琀栀攀漀 搀椀⸀∀ഀഀ
"[english]GameUI_SteamStatsNowTracking"	"A connection to Steam has been established and your statistics will now be tracked."਍∀䜀愀洀攀唀䤀开䜀愀洀攀䴀攀渀甀开䴀愀椀渀䴀攀渀甀∀ऀ∀吀刀찀一䠀 ကꀁ丁 䌀䠀촀一䠀∀ഀഀ
"[english]GameUI_GameMenu_MainMenu"	"MAIN MENU"਍∀䜀愀洀攀唀䤀开䜀愀洀攀䴀攀渀甀开吀爀愀椀渀椀渀最∀ऀ∀䠀꼀丞䜀 䐀ꨀ丞∀ഀഀ
"[english]GameUI_GameMenu_Training"	"TUTORIAL"਍∀䜀愀洀攀唀䤀开䜀愀洀攀䴀攀渀甀开伀昀昀氀椀渀攀倀爀愀挀琀椀挀攀∀ऀ∀吀가倞 䰀唀夀였丞 伀䘀䘀䰀䤀一䔀∀ഀഀ
"[english]GameUI_GameMenu_OfflinePractice"	"OFFLINE PRACTICE"਍∀䜀愀洀攀唀䤀开刀攀猀攀琀匀琀愀琀猀∀ऀ∀က뜁琞 氀ꄀ椞 琀ꔀ琞 挀ꌀ„挀栀준„猀턀∞ഀഀ
"[english]GameUI_ResetStats"	"Reset All Stats"਍∀䜀愀洀攀唀䤀开䌀漀渀昀椀爀洀刀攀猀攀琀匀琀愀琀猀吀椀琀氀攀∀ऀ∀က뜁琞 氀ꄀ椞 洀촀椞 琀栀渀最 猀턀∞ഀഀ
"[english]GameUI_ConfirmResetStatsTitle"	"Reset All Stats"਍∀䜀愀洀攀唀䤀开䌀漀渀昀椀爀洀刀攀猀攀琀匀琀愀琀猀吀攀砀琀∀ऀ∀䈀ꄀ渞 挀 挀栀꼀挞 洀渀栀 洀甀턀渞 ᄀ뜁琞 氀ꄀ椞 琀ꔀ琞 挀ꌀ„琀栀渀最 猀턀㼞 䈀ꄀ渞 瘀꬀渞 猀봀„最椀„氀ꄀ椞 渀栀渞最 琀栀渀栀 琀甞 ᄀ ᄀꄁ琞 ᄀ뀁挞Ⰰ 渀栀뀀渁最 猀봀„洀ꔀ琞 琀椀뼀渞 ᄀ„ᄀ뼁渞 渀栀渞最 琀栀渀栀 琀甞 琀뀀ꄁ渁最 氀愀椀⸀∀ഀഀ
"[english]GameUI_ConfirmResetStatsText"	"Are you sure you want to reset all stats?  You will keep existing achievements, but progress towards future achievements will be lost."਍∀䜀愀洀攀唀䤀开刀攀猀攀琀∀ऀ∀က뜁琞 氀ꄀ椞 洀촀椞 琀栀渀最 猀턀∞ഀഀ
"[english]GameUI_Reset"	"Reset All Stats"਍∀䜀愀洀攀唀䤀开䴀漀甀猀攀刀愀眀∀ऀ∀䐀„氀椀윀甞 瘀漀 琀爀挞 琀椀뼀瀞∀ഀഀ
"[english]GameUI_MouseRaw"	"Raw input"਍∀䜀愀洀攀唀䤀开䴀漀甀猀攀刀愀眀开䠀椀渀琀∀ऀ∀䐀椀 氀椀윀甞 瘀漀 琀爀挞 琀椀뼀瀞 猀봀„ᄀ촁挞 挀栀甀礀쌀渞 ᄀ渞最 挀栀甀琞 琀栀대渞最 琀„琀栀椀뼀琞 戀쬀Ⱎ 戀케„焀甀愀 琀栀椀뼀琞 氀관瀞 挀栀甀琞 挀愞 戀ꌀ渞最 ᄀ椁섀甞 欀栀椀쌀渞 瘀 挀甀渀最 挀ꔀ瀞 挀栀甀礀쌀渞 ᄀ渞最 挀栀甀琞 砀挀 琀栀挞 栀ꄀ渁⸀∀ഀഀ
"[english]GameUI_MouseRaw_Hint"	"Raw input reads mouse movement directly from the device, bypassing control panel mouse settings, and providing more reliable mouse movement."਍∀䜀愀洀攀唀䤀开䴀漀甀猀攀䄀挀挀攀氀攀爀愀琀椀漀渀∀ऀ∀吀̀渁最 琀턀挞 挀栀甀琞∀ഀഀ
"[english]GameUI_MouseAcceleration"	"Mouse acceleration"਍∀䜀愀洀攀唀䤀开䴀漀甀猀攀䄀挀挀攀氀攀爀愀琀椀漀渀开䠀椀渀琀∀ऀ∀䬀挀栀 栀漀ꄀ琞 琀̀渁最 琀턀挞 挀栀甀琞 ⠀欀栀甀礀渀 搀豈渀最 欀栀椀 猀„搀渞最 搀„氀椀윀甞 ᄀ꜁甞 瘀漀 琀爀挞 琀椀뼀瀞 ⴀ 爀愀眀 椀渀瀀甀琀⤀∀ഀഀ
"[english]GameUI_MouseAcceleration_Hint"	"Enable mouse acceleration (recommended when using raw input)"਍∀䜀愀洀攀唀䤀开䴀漀甀猀攀䄀挀挀攀氀攀爀愀琀椀漀渀䄀洀漀甀渀琀开䠀椀渀琀∀ऀ∀䴀挞 ᄀ„琀̀渁最 琀턀挞⸀ 䜀椀 琀爀쬀„㄀⸀　 琀挞 氀 欀栀渀最 琀̀渁最 琀턀挞㬀 挀挀 最椀 琀爀쬀„挀愀漀 栀ꄀ渁 猀봀„欀栀椀뼀渞 琀̀渁最 琀턀挞 渀栀椀섀甞 栀ꄀ渁⸀∀ഀഀ
"[english]GameUI_MouseAccelerationAmount_Hint"	"Amount of acceleration. A value of 1.0 is unaccelerated; higher values will provide additional acceleration."਍∀䜀愀洀攀唀䤀开匀攀爀瘀攀爀䌀漀渀渀攀挀琀伀甀琀伀昀䐀愀琀攀∀ऀ∀䴀礀 挀栀„挀栀뀀愁 ᄀ뀁挞 挀관瀞 渀栀관琞 ᄀ뼁渞 瀀栀椀渀 戀ꌀ渞 最꜀渞 ᄀ礀 渀栀ꔀ琞⸀尀渀∀ഀഀ
"[english]GameUI_ServerConnectOutOfDate"	"Server has not updated to the most recent version.\n"਍∀䜀愀洀攀唀䤀开匀攀爀瘀攀爀䌀栀愀氀氀攀渀最攀䤀渀挀漀爀爀攀挀琀∀ऀ∀䴀礀 挀栀„欀栀渀最 栀팀椞 ᄀ瀀 ᄀ度渀最 瘀椞 挀挀 琀栀„琀栀挀栀⸀尀渀䌀 琀栀쌀„渀 ᄀ 焀甀 栀ꄀ渞⸀尀渀∀ഀഀ
"[english]GameUI_ServerChallengeIncorrect"	"Server did not respond with the correct challenge.\nIt may be out of date.\n"਍∀䜀愀洀攀唀䤀开匀攀爀瘀攀爀䤀渀猀攀挀甀爀攀∀ऀ∀䈀ꄀ渞 ᄀ愁渀最 ?„挀栀뼀„ᄀ„欀栀渀最 戀ꌀ漞 洀관琞⸀ 䈀ꄀ渞 瀀栀ꌀ椞 欀栀?椞 ᄀ渞最 氀ꄀ椞 琀爀뀀挞 欀栀椀 欀뼀琞 渀턀椞 琀椞 洀礀 挀栀„戀ꌀ漞 洀관琞⸀尀渀∀ഀഀ
"[english]GameUI_ServerInsecure"	"You are in insecure mode.  You must restart before you can connect to secure servers.\n"਍∀䜀愀洀攀唀䤀开匀攀爀瘀攀爀刀攀樀攀挀琀䰀䄀一刀攀猀琀爀椀挀琀∀ऀ∀䌀挀 洀礀 挀栀„挀挞 戀„⠀䰀䄀一 猀攀爀瘀攀爀猀⤀ 戀쬀„最椀椞 栀ꄀ渞 挀栀漀 挀挀 洀礀 琀爀ꄀ洞 挀挞 戀„⠀挀ꔀ瀞 䌀⤀⸀尀渀∀ഀഀ
"[english]GameUI_ServerRejectLANRestrict"	"LAN servers are restricted to local clients (class C).\n"਍∀䜀愀洀攀唀䤀开匀攀爀瘀攀爀刀攀樀攀挀琀伀氀搀嘀攀爀猀椀漀渀∀ऀ∀䴀礀 挀栀„戀ꄀ渞 ᄀ愁渀最 欀뼀琞 渀턀椞 琀椞 栀椀윀渞 ᄀ愁渀最 挀栀ꄀ礞 洀琞尀渀瀀栀椀渀 戀ꌀ渞 挀椀 挀愞 琀爀 挀栀ꄀ椁⸀尀渀∀ഀഀ
"[english]GameUI_ServerRejectOldVersion"	"The server you are trying to connect to is running\nan older version of the game.\n"਍∀䜀愀洀攀唀䤀开匀攀爀瘀攀爀刀攀樀攀挀琀䈀愀搀匀琀攀愀洀䬀攀礀∀ऀ∀က„搀椀 洀 匀琀攀愀洀 欀栀渀最 栀瀞 氀윀尞渀∀ഀഀ
"[english]GameUI_ServerRejectBadSteamKey"	"Invalid Steam key length\n"਍∀䜀愀洀攀唀䤀开匀攀爀瘀攀爀刀攀樀攀挀琀伀氀搀倀爀漀琀漀挀漀氀∀ऀ∀䴀礀 挀栀„渀礀 搀豈渀最 洀琞 瀀栀뀀ꄁ渁最 琀栀挞 挀椀 栀ꄀ渁 渞最 搀渞最 挀愞 戀ꄀ渞⸀尀渀∀ഀഀ
"[english]GameUI_ServerRejectOldProtocol"	"This server is using an older protocol than your client.\n"਍∀䜀愀洀攀唀䤀开匀攀爀瘀攀爀刀攀樀攀挀琀一攀眀倀爀漀琀漀挀漀氀∀ऀ∀䴀礀 挀栀„渀礀 搀豈渀最 洀琞 瀀栀뀀ꄁ渁最 琀栀挞 洀椞 栀ꄀ渁 渞最 搀渞最 挀愞 戀ꄀ渞⸀尀渀∀ഀഀ
"[english]GameUI_ServerRejectNewProtocol"	"This server is using a newer protocol than your client.\n"਍∀䜀愀洀攀唀䤀开匀攀爀瘀攀爀刀攀樀攀挀琀䤀渀瘀愀氀椀搀䌀攀爀琀䰀攀渀∀ऀ∀က„搀椀 挀栀渞最 挀栀준„砀挀 琀栀挞 欀栀渀最 栀瀞 氀윀⸞尀渀∀ഀഀ
"[english]GameUI_ServerRejectInvalidCertLen"	"Invalid authentication certificate length.\n"਍∀䜀愀洀攀唀䤀开匀攀爀瘀攀爀刀攀樀攀挀琀䤀渀瘀愀氀椀搀匀琀攀愀洀䌀攀爀琀䰀攀渀∀ऀ∀䰀휀椞 ᄀ„搀椀 挀栀渞最 琀栀挞 匀吀䔀䄀䴀℀尀渀∀ഀഀ
"[english]GameUI_ServerRejectInvalidSteamCertLen"	"STEAM certificate length error!\n"਍∀䜀愀洀攀唀䤀开匀攀爀瘀攀爀刀攀樀攀挀琀䜀匀∀ऀ∀䜀匀䌀爀攀愀琀攀䰀漀挀愀氀唀猀攀爀 琀栀ꔀ琞 戀ꄀ椞尀渀∀ഀഀ
"[english]GameUI_ServerRejectGS"	"GSCreateLocalUser failed\n"਍∀䜀愀洀攀唀䤀开匀攀爀瘀攀爀䄀甀琀栀䐀椀猀愀戀氀攀搀∀ऀ∀堀挀 琀栀挞 ᄀ 琀꼀琞⸀尀渀∀ഀഀ
"[english]GameUI_ServerAuthDisabled"	"Authentication disabled.\n"਍∀䜀愀洀攀唀䤀开匀攀爀瘀攀爀䌀䐀䬀攀礀䄀甀琀栀䤀渀瘀愀氀椀搀∀ऀ∀堀挀 琀栀挞 洀 䌀䐀 䬀攀礀 欀栀渀最 栀瀞 氀윀„挀栀漀 洀礀 挀栀„琀爀渀 洀ꄀ渞最⸀尀渀∀ഀഀ
"[english]GameUI_ServerCDKeyAuthInvalid"	"CD Key authentication invalid for internet servers.\n"਍∀䜀愀洀攀唀䤀开匀攀爀瘀攀爀䤀渀瘀愀氀椀搀䌀䐀䬀攀礀∀ऀ∀䴀 䌀䐀 欀栀渀最 栀瀞 氀윀⸞尀渀∀ഀഀ
"[english]GameUI_ServerInvalidCDKey"	"Invalid CD Key.\n"਍∀䜀愀洀攀唀䤀开匀攀爀瘀攀爀䌀䐀䬀攀礀䤀渀唀猀攀∀ऀ∀䴀 䌀䐀 ᄀ ᄀ뀁挞 猀„搀渞最⸀尀渀∀ഀഀ
"[english]GameUI_ServerCDKeyInUse"	"CD Key already in use.\n"਍∀䜀愀洀攀唀䤀开䌀爀漀猀猀栀愀椀爀一漀渀攀∀ऀ∀䬀栀渀最∀ഀഀ
"[english]GameUI_CrosshairNone"	"None"਍∀䜀愀洀攀唀䤀开匀琀攀愀洀嘀漀椀挀攀∀ऀ∀䴀뜀挞 ᄀ쬁渞栀Ⰰ 洀 琀栀漀ꄀ椞 匀琀攀愀洀 猀봀„ᄀ뀁挞 猀„搀渞最Ⰰ 渀栀뀀渁最 洀琞 猀턀„洀礀 挀栀„挀 琀栀쌀„搀豈渀最 琀栀椀뼀琞 氀관瀞 挀椀 戀渀 搀뀀椞⸀∀ഀഀ
"[english]GameUI_SteamVoice"	"Steam Voice is used by default, but some servers may use the old settings below."਍∀䜀愀洀攀唀䤀开匀琀攀愀洀嘀漀椀挀攀匀攀琀琀椀渀最猀∀ऀ∀吀栀椀뼀琞 氀관瀞 洀 琀栀漀ꄀ椞 匀琀攀愀洀∀ഀഀ
"[english]GameUI_SteamVoiceSettings"	"Steam Voice Settings"਍∀䜀愀洀攀唀䤀开䜀愀洀攀䴀攀渀甀开刀攀瀀氀愀礀䐀攀洀漀猀∀ऀ∀倀䠀섀吀 䰀ꀀ䤞∀ഀഀ
"[english]GameUI_GameMenu_ReplayDemos"	"REPLAYS"਍∀䜀愀洀攀唀䤀开䜀愀洀攀䴀攀渀甀开刀攀猀甀洀攀刀攀瀀氀愀礀∀ऀ∀吀䤀븀倞 吀䌞 倀䠀섀吀 䰀ꀀ䤞∀ഀഀ
"[english]GameUI_GameMenu_ResumeReplay"	"RESUME REPLAY"਍∀䜀愀洀攀唀䤀开䜀愀洀攀䴀攀渀甀开䔀砀椀琀刀攀瀀氀愀礀∀ऀ∀嘀쀀„䴀䌞 倀䠀섀吀 䰀ꀀ䤞∀ഀഀ
"[english]GameUI_GameMenu_ExitReplay"	"BACK TO REPLAYS"਍∀䜀愀洀攀唀䤀开瘀漀琀攀开礀攀猀开戀椀渀搀椀渀最∀ऀ∀䌀㨀 ─猀㄀∀ഀഀ
"[english]GameUI_vote_yes_binding"	"Yes: %s1"਍∀䜀愀洀攀唀䤀开瘀漀琀攀开渀漀开戀椀渀搀椀渀最∀ऀ∀䬀栀渀最㨀 ─猀㄀∀ഀഀ
"[english]GameUI_vote_no_binding"	"No: %s1"਍∀䜀愀洀攀唀䤀开瘀漀琀攀开礀攀猀开琀愀氀氀礀∀ऀ∀က팁渞最 ﴀ∀ഀഀ
"[english]GameUI_vote_yes_tally"	"Yes"਍∀䜀愀洀攀唀䤀开瘀漀琀攀开渀漀开琀愀氀氀礀∀ऀ∀䬀栀渀最∀ഀഀ
"[english]GameUI_vote_no_tally"	"No"਍∀䜀愀洀攀唀䤀开瘀漀琀攀开渀漀开椀渀猀琀爀甀挀琀椀漀渀开愀∀ऀ∀一栀ꔀ渞 吀刀?„䰀ꀀ䤞∀ഀഀ
"[english]GameUI_vote_no_instruction_a"	"Press BACK"਍∀䜀愀洀攀唀䤀开瘀漀琀攀开礀攀猀开瀀挀开椀渀猀琀爀甀挀琀椀漀渀∀ऀ∀一栀ꔀ渞 䘀㄀ ᄀ쌁„挀栀촀渞 䌀팀∀ഀഀ
"[english]GameUI_vote_yes_pc_instruction"	"Press F1 to vote YES"਍∀䜀愀洀攀唀䤀开瘀漀琀攀开渀漀开瀀挀开椀渀猀琀爀甀挀琀椀漀渀∀ऀ∀一栀ꔀ渞 䘀㈀ ᄀ쌁„挀栀촀渞 䬀䠀퐀一䜀∀ഀഀ
"[english]GameUI_vote_no_pc_instruction"	"Press F2 to vote NO"਍∀䜀愀洀攀唀䤀开瘀漀琀攀开瀀愀猀猀攀搀∀ऀ∀夀甀 挀꜀甞 琀栀渀最 焀甀愀∀ഀഀ
"[english]GameUI_vote_passed"	"Vote Passed"਍∀䜀愀洀攀唀䤀开瘀漀琀攀开昀愀椀氀攀搀∀ऀ∀夀甀 挀꜀甞 瀀栀„焀甀礀뼀琞∀ഀഀ
"[english]GameUI_vote_failed"	"Vote Failed"਍∀䜀愀洀攀唀䤀开瘀漀琀攀开昀愀椀氀攀搀开焀甀漀爀甀洀∀ऀ∀䬀栀渀最 ᄀ„渀最뀀?椞 挀栀ꄀ椁 戀渀栀 挀栀촀渞⸀∀ഀഀ
"[english]GameUI_vote_failed_quorum"	"Not enough players voted."਍∀䜀愀洀攀唀䤀开瘀漀琀攀开昀愀椀氀攀搀开瘀漀琀攀开猀瀀愀洀∀ऀ∀䈀ꄀ渞 礀甀 挀꜀甞 戀케„瀀栀椀뼀甞 最꜀渞 ᄀ礀 瘀 欀栀渀最 琀栀쌀„礀甀 挀꜀甞 渀愞 琀爀漀渀最 ─猀㄀ 最椀礀⸀∀ഀഀ
"[english]GameUI_vote_failed_vote_spam"	"You called a vote recently and can not call another for %s1 seconds."਍∀䜀愀洀攀唀䤀开瘀漀琀攀开昀愀椀氀攀搀开洀愀瀀开渀愀洀攀开爀攀焀甀椀爀攀搀∀ऀ∀䈀ꄀ渞 瀀栀ꌀ椞 挀栀촀渞 洀琞 琀渀 戀ꌀ渞 ᄀ팁⸞∀ഀഀ
"[english]GameUI_vote_failed_map_name_required"	"You must specify a map name."਍∀䜀愀洀攀唀䤀开瘀漀琀攀开昀愀椀氀攀搀开眀愀椀琀椀渀最昀漀爀瀀氀愀礀攀爀猀∀ऀ∀䬀栀渀最 ᄀ뀁挞 戀꜀甞 挀栀촀渞 琀爀漀渀最 欀栀椀 ᄀ愁渀最 挀栀?„渀最뀀?椞 挀栀ꄀ椁⸀∀ഀഀ
"[english]GameUI_vote_failed_waitingforplayers"	"Voting not allowed while Waiting For Players."਍∀䜀愀洀攀唀䤀开挀愀氀氀开瘀漀琀攀∀ऀ∀䈀椀쌀甞 焀甀礀뼀琞∀ഀഀ
"[english]GameUI_call_vote"	"Call vote"਍∀䜀愀洀攀唀䤀开䌀愀渀挀攀氀䈀漀氀搀∀ऀ∀䠀礞∀ഀഀ
"[english]GameUI_CancelBold"	"CANCEL"਍∀䜀愀洀攀唀䤀开䰀愀渀最甀愀最攀开刀漀洀愀渀椀愀渀∀ऀ∀吀椀뼀渞最 刀漀洀愀渀椀∀ഀഀ
"[english]GameUI_Language_Romanian"	"Romanian"਍∀䜀愀洀攀唀䤀开䰀愀渀最甀愀最攀开吀甀爀欀椀猀栀∀ऀ∀吀椀뼀渞最 吀栀픀„一栀⤀ 䬀∞ഀഀ
"[english]GameUI_Language_Turkish"	"Turkish"਍∀䜀愀洀攀唀䤀开䰀愀渀最甀愀最攀开䠀甀渀最愀爀椀愀渀∀ऀ∀吀椀뼀渞最 䠀甀渀最愀爀礀∀ഀഀ
"[english]GameUI_Language_Hungarian"	"Hungarian"਍∀䜀愀洀攀唀䤀开䌀漀渀昀椀爀洀∀ऀ∀堀섀䌀 一䠀가丞∀ഀഀ
"[english]GameUI_Confirm"	"CONFIRM"਍∀䐀伀吀䄀开吀漀漀氀琀椀瀀开愀戀椀氀椀琀礀开氀椀挀栀开挀栀愀椀渀开昀爀漀猀琀开挀愀猀琀开爀愀渀最攀开猀挀攀瀀琀攀爀∀ऀ∀吀ꘀ䴞 吀䠀䤀 吀刀䤀숀丞 ⠀匀䌀䔀倀吀䔀刀⤀㨀∀ഀഀ
"[english]DOTA_Tooltip_ability_lich_chain_frost_cast_range_scepter"	"SCEPTER CAST RANGE:"਍∀䜀愀洀攀唀䤀开䜀愀洀攀䴀攀渀甀开䄀挀琀椀瘀愀琀攀嘀刀∀ऀ∀䬀촀䌀䠀 䠀伀ꀀ吞 吀䠀䌞 吀븀„ꈀ伞∀ഀഀ
"[english]GameUI_GameMenu_ActivateVR"	"ACTIVATE VIRTUAL REALITY"਍∀䜀愀洀攀唀䤀开䜀愀洀攀䴀攀渀甀开䐀攀愀挀琀椀瘀愀琀攀嘀刀∀ऀ∀吀글吞 吀䠀䌞 吀븀„ꈀ伞∀ഀഀ
"[english]GameUI_GameMenu_DeactivateVR"	"DEACTIVATE VIRTUAL REALITY"਍∀䜀愀洀攀唀䤀开嘀刀䴀漀搀攀∀ऀ∀䌀栀뼀„ᄀ„琀栀挞 琀뼀„ꌀ漞∀ഀഀ
"[english]GameUI_VRMode"	"Virtual Reality Mode"਍∀䜀愀洀攀唀䤀开嘀刀䴀漀搀攀刀攀氀愀甀渀挀栀䴀猀最∀ऀ∀䬀挀栀 栀漀ꄀ琞 栀漀뜀挞 瘀 栀椀윀甞 挀栀뼀„ᄀ„琀栀挞 琀뼀„ꌀ漞 猀봀„欀栀渀最 栀漀ꄀ琞 ᄀ渞最 挀栀漀 琀椞 欀栀椀 戀ꄀ渞 欀栀케椞 ᄀ渞最 氀ꄀ椞 琀爀 挀栀ꄀ椁⸀∀ഀഀ
"[english]GameUI_VRModeRelaunchMsg"	"Enabling or disabling Virtual Reality Mode will not take effect until you restart the game."਍∀䜀愀洀攀唀䤀开圀椀渀搀漀眀攀搀吀漀漀氀琀椀瀀∀ऀ∀䬀栀椀 挀栀뼀„ᄀ„琀栀挞 琀뼀„ꌀ漞 ⠀嘀刀⤀ ᄀ뀁挞 戀관琞Ⰰ 琀爀 挀栀ꄀ椁 猀봀„戀꼀琞 ᄀ꜁甞 搀뀀椞 搀ꄀ渞最 挀愞 猀픀„琀爀渀 洀渀 栀渀栀 挀栀渀栀⸀ 䌀栀촀渞 尀∀䬀挀栀 栀漀ꄀ琞 琀栀挞 琀뼀„ꌀ漞尀∀ ᄀ쌁„挀栀甀礀쌀渞 猀愀渀最 挀栀뼀„ᄀ„琀栀挞 琀뼀„ꌀ漞⸀∀ഀഀ
"[english]GameUI_WindowedTooltip"	"When VR mode is enabled the game will start windowed on the main display. Select Activate Virtual Reality to switch to VR."਍∀䜀愀洀攀唀䤀开一漀嘀刀吀漀漀氀琀椀瀀∀ऀ∀䬀栀渀最 琀洀 琀栀ꔀ礞 洀渀 栀渀栀 栀椀쌀渞 琀栀쬀⸞ 䠀礀 欀뼀琞 渀턀椞 洀渀 琀栀挞 琀뼀„ꌀ漞 琀뀀ꄁ渁最 琀栀挀栀 挀愞 戀ꄀ渞 瘀 欀栀?椞 ᄀ渞最 氀ꄀ椞 琀爀 挀栀ꄀ椁 ᄀ쌁„欀挀栀 栀漀ꄀ琞 挀栀뼀„ᄀ„琀栀挞 琀뼀„ꌀ漞⸀∀ഀഀ
"[english]GameUI_NoVRTooltip"	"No display detected. Connect your compatible VR display and restart the game to enable VR mode."਍∀䜀愀洀攀唀䤀开䠀䐀䌀漀渀琀攀渀琀∀ऀ∀一ꄀ瀞 渀椞 搀甀渀最 䠀䐀 渀뼀甞 挀 琀栀쌀∞ഀഀ
"[english]GameUI_HDContent"	"Load HD content if available"਍∀䜀愀洀攀唀䤀开䠀䐀刀攀猀琀愀爀琀刀攀焀甀椀爀攀搀开䤀渀昀漀∀ऀ∀吀爀 挀栀ꄀ椁 挀꜀渞 ᄀ뀁挞 欀栀?椞 ᄀ渞最 氀ꄀ椞 ᄀ쌁„渀栀渞最 琀栀愀礀 ᄀ픁椞 戀ꄀ渞 瘀愞 氀洀 挀 栀椀윀甞 氀挞⸀∀ഀഀ
"[english]GameUI_HDRestartRequired_Info"	"The changes you have made require the game to be restarted to take effect."਍∀䜀愀洀攀唀䤀开倀漀爀琀愀氀䐀攀瀀琀栀㐀∀ऀ∀㐀∀ഀഀ
"[english]GameUI_PortalDepth4"	"4"਍∀䜀愀洀攀唀䤀开䤀挀漀渀猀开䈀䄀䌀䬀∀ऀ∀㐀∀ഀഀ
"[english]GameUI_Icons_BACK"	"4"਍∀䜀愀洀攀唀䤀开䰀愀渀最甀愀最攀开䌀稀攀挀栀∀ऀ∀吀椀뼀渞最 匀挀∀ഀഀ
"[english]GameUI_Language_Czech"	"Czech"਍∀䜀愀洀攀唀䤀开䰀愀渀最甀愀最攀开䈀爀愀稀椀氀椀愀渀∀ऀ∀吀椀뼀渞最 䈀팀„က漀 一栀愀 ⴀ 䈀爀愀稀椀氀∀ഀഀ
"[english]GameUI_Language_Brazilian"	"Portuguese-Brazil"਍∀䜀愀洀攀唀䤀开䰀愀渀最甀愀最攀开䈀甀氀最愀爀椀愀渀∀ऀ∀吀椀뼀渞最 䈀甀氀最愀爀椀∀ഀഀ
"[english]GameUI_Language_Bulgarian"	"Bulgarian"਍∀䜀愀洀攀唀䤀开䰀愀渀最甀愀最攀开䜀爀攀攀欀∀ऀ∀吀椀뼀渞最 䠀礀 䰀ꄀ瀞∀ഀഀ
"[english]GameUI_Language_Greek"	"Greek"਍∀䜀愀洀攀唀䤀开䰀愀渀最甀愀最攀开唀欀爀愀椀渀椀愀渀∀ऀ∀吀椀뼀渞最 唀欀爀愀椀渀愀∀ഀഀ
"[english]GameUI_Language_Ukrainian"	"Ukrainian"਍∀䜀愀洀攀唀䤀开瘀漀琀攀开昀愀椀氀攀搀开瘀漀琀攀开猀瀀愀洀开洀椀渀∀ऀ∀䈀ꄀ渞 礀甀 挀꜀甞 戀케„瀀栀椀뼀甞 最꜀渞 ᄀ礀 瘀 欀栀渀最 琀栀쌀„礀甀 挀꜀甞 渀愞 琀爀漀渀最 ─猀㄀ 瀀栀切琀⸀∀ഀഀ
"[english]GameUI_vote_failed_vote_spam_min"	"You called a vote recently and can not call another for %s1 minute."਍∀䜀愀洀攀唀䤀开瘀漀琀攀开昀愀椀氀攀搀开瘀漀琀攀开猀瀀愀洀开洀椀渀猀∀ऀ∀䈀ꄀ渞 礀甀 挀꜀甞 戀케„瀀栀椀뼀甞 最꜀渞 ᄀ礀 瘀 欀栀渀最 琀栀쌀„礀甀 挀꜀甞 渀愞 琀爀漀渀最 ─猀㄀ 瀀栀切琀⸀∀ഀഀ
"[english]GameUI_vote_failed_vote_spam_mins"	"You called a vote recently and can not call another for %s1 minutes."਍∀䜀愀洀攀唀䤀开瘀漀琀攀开昀愀椀氀攀搀开挀愀渀渀漀琀开欀椀挀欀∀ऀ∀一最뀀?椞 挀栀ꄀ椁 渀礀 欀栀渀最 琀栀뼀„戀쬀„ᄀ甁픀椞 琀爀漀渀最 ─猀㄀ 最椀礀 渀愞⸀∀ഀഀ
"[english]GameUI_vote_failed_cannot_kick"	"This player cannot be kicked for %s1 more seconds."਍∀䜀愀洀攀唀䤀开瘀漀琀攀开昀愀椀氀攀搀开挀愀渀渀漀琀开欀椀挀欀开洀椀渀∀ऀ∀一最뀀?椞 挀栀ꄀ椁 渀礀 欀栀渀最 琀栀뼀„戀쬀„ᄀ甁픀椞 琀爀漀渀最 ─猀㄀ 瀀栀切琀 渀愞⸀∀ഀഀ
"[english]GameUI_vote_failed_cannot_kick_min"	"This player cannot be kicked for %s1 more minute."਍∀䜀愀洀攀唀䤀开瘀漀琀攀开昀愀椀氀攀搀开挀愀渀渀漀琀开欀椀挀欀开洀椀渀猀∀ऀ∀一最뀀?椞 挀栀ꄀ椁 渀礀 欀栀渀最 琀栀뼀„戀쬀„ᄀ甁픀椞 琀爀漀渀最 ─猀㄀ 瀀栀切琀 渀愞⸀∀ഀഀ
"[english]GameUI_vote_failed_cannot_kick_mins"	"This player cannot be kicked for %s1 more minutes."਍∀䜀愀洀攀唀䤀开瘀漀琀攀开昀愀椀氀攀搀开瘀漀琀攀开椀渀开瀀爀漀最爀攀猀猀∀ऀ∀䴀琞 戀渀栀 挀栀촀渞 ᄀ愁渀最 搀椀씀渞 爀愀⸀∀ഀഀ
"[english]GameUI_vote_failed_vote_in_progress"	"A vote is currently in progress."਍∀䜀愀洀攀唀䤀开瘀漀琀攀开礀攀猀开猀挀开椀渀猀琀爀甀挀琀椀漀渀∀ऀ∀一栀ꔀ渞 ─挀氀开琀爀椀最最攀爀开昀椀爀猀琀开渀漀琀椀昀椀挀愀琀椀漀渀─ ᄀ쌁„挀栀촀渞 䌀팀∀ഀഀ
"[english]GameUI_vote_yes_sc_instruction"	"Press %cl_trigger_first_notification% to vote YES"਍∀䜀愀洀攀唀䤀开瘀漀琀攀开渀漀开猀挀开椀渀猀琀爀甀挀琀椀漀渀∀ऀ∀一栀ꔀ渞 ─挀氀开搀攀挀氀椀渀攀开昀椀爀猀琀开渀漀琀椀昀椀挀愀琀椀漀渀─ ᄀ쌁„挀栀촀渞 䬀䠀퐀一䜀∀ഀഀ
"[english]GameUI_vote_no_sc_instruction"	"Press %cl_decline_first_notification% to vote NO"਍∀䜀愀洀攀唀䤀开刀攀瀀漀爀琀倀氀愀礀攀爀∀ऀ∀吀턀„挀漀 渀最뀀?椞 挀栀ꄀ椁∀ഀഀ
"[english]GameUI_ReportPlayer"	"Report Player"਍∀䜀愀洀攀唀䤀开刀攀瀀漀爀琀倀氀愀礀攀爀䌀愀瀀猀∀ऀ∀吀퀀„䌀섀伀 一䜀꼀?䤞 䌀䠀ꀀ䤁∀ഀഀ
"[english]GameUI_ReportPlayerCaps"	"REPORT PLAYER"਍∀䜀愀洀攀唀䤀开刀攀瀀漀爀琀倀氀愀礀攀爀刀攀愀猀漀渀∀ऀ∀䰀ﴀ 搀漀㨀∀ഀഀ
"[english]GameUI_ReportPlayerReason"	"Reason:"਍∀䜀愀洀攀唀䤀开刀攀瀀漀爀琀倀氀愀礀攀爀开䌀栀漀漀猀攀∀ऀ∀ⴀⴀ䌀栀촀渞 氀ﴀ 搀漀ⴀⴀ∀ഀഀ
"[english]GameUI_ReportPlayer_Choose"	"--Choose Reason--"਍∀䜀愀洀攀唀䤀开刀攀瀀漀爀琀倀氀愀礀攀爀开䌀栀攀愀琀椀渀最∀ऀ∀䜀椀愀渀 氀관渞∀ഀഀ
"[english]GameUI_ReportPlayer_Cheating"	"Cheating"਍∀䜀愀洀攀唀䤀开刀攀瀀漀爀琀倀氀愀礀攀爀开䤀搀氀攀∀ऀ∀䌀栀?⼞䄀䘀䬀∀ഀഀ
"[english]GameUI_ReportPlayer_Idle"	"Idle/AFK"਍∀䜀愀洀攀唀䤀开刀攀瀀漀爀琀倀氀愀礀攀爀开䠀愀爀愀猀猀洀攀渀琀∀ऀ∀儀甀ꔀ礞 爀턀椞∀ഀഀ
"[english]GameUI_ReportPlayer_Harassment"	"Harassment"਍∀䜀愀洀攀唀䤀开倀愀甀猀攀搀吀椀洀攀爀∀ऀ∀က쌁 䐀丞䜀 ⴀ ─猀㄀∀ഀഀ
"[english]GameUI_PausedTimer"	"PAUSED - %s1"਍紀ഀഀ
}਍
