"lang"਍笀ഀഀ
"Language"	"latam"਍∀吀漀欀攀渀猀∀ഀഀ
{਍∀䜀愀洀攀唀䤀开刀攀瘀攀爀猀攀䴀漀甀猀攀∀ऀ∀䤀渀瘀攀爀琀椀爀 爀愀琀渀∀ഀഀ
"[english]GameUI_ReverseMouse"	"Reverse mouse"਍∀䜀愀洀攀唀䤀开刀攀瘀攀爀猀攀䴀漀甀猀攀䰀愀戀攀氀∀ऀ∀䤀渀瘀攀爀琀椀爀 攀樀攀 瘀攀爀琀椀挀愀氀 搀攀氀 爀愀琀渀∀ഀഀ
"[english]GameUI_ReverseMouseLabel"	"Reverse mouse up-down axis"਍∀䜀愀洀攀唀䤀开䴀漀甀猀攀䰀漀漀欀∀ऀ∀嘀椀猀琀愀 爀愀琀渀∀ഀഀ
"[english]GameUI_MouseLook"	"Mouse look"਍∀䜀愀洀攀唀䤀开䴀漀甀猀攀䰀漀漀欀䰀愀戀攀氀∀ऀ∀唀猀愀爀 爀愀琀渀 瀀愀爀愀 洀椀爀愀爀 愀氀爀攀搀攀搀漀爀∀ഀഀ
"[english]GameUI_MouseLookLabel"	"Use the mouse to look around"਍∀䜀愀洀攀唀䤀开䴀漀甀猀攀䘀椀氀琀攀爀∀ऀ∀䘀椀氀琀爀漀 搀攀 爀愀琀渀∀ഀഀ
"[english]GameUI_MouseFilter"	"Mouse filter"਍∀䜀愀洀攀唀䤀开䴀漀甀猀攀䘀椀氀琀攀爀䰀愀戀攀氀∀ऀ∀匀甀愀瘀椀稀愀爀 攀氀 洀漀瘀椀洀椀攀渀琀漀 搀攀氀 爀愀琀渀 攀渀琀爀攀 ㈀ 昀爀愀洀攀猀⸀∀ഀഀ
"[english]GameUI_MouseFilterLabel"	"Smooth out mouse movement over 2 frames."਍∀䜀愀洀攀唀䤀开䴀漀甀猀攀匀攀渀猀椀琀椀瘀椀琀礀∀ऀ∀匀攀渀猀椀戀椀氀椀搀愀搀 搀攀氀 爀愀琀渀∀ഀഀ
"[english]GameUI_MouseSensitivity"	"Mouse sensitivity"਍∀䜀愀洀攀唀䤀开䨀漀礀猀琀椀挀欀∀ऀ∀䌀漀渀琀爀漀氀∀ഀഀ
"[english]GameUI_Joystick"	"Gamepad"਍∀䜀愀洀攀唀䤀开䨀漀礀猀琀椀挀欀䰀愀戀攀氀∀ऀ∀䄀挀琀椀瘀愀爀 攀氀 洀愀渀搀漀∀ഀഀ
"[english]GameUI_JoystickLabel"	"Enable the gamepad"਍∀䜀愀洀攀唀䤀开刀攀瘀攀爀猀攀䨀漀礀猀琀椀挀欀∀ऀ∀䤀渀瘀攀爀琀椀爀 攀氀 攀樀攀 瘀攀爀琀椀挀愀氀 搀攀氀 洀愀渀搀漀∀ഀഀ
"[english]GameUI_ReverseJoystick"	"Reverse gamepad up-down axis"਍∀䜀愀洀攀唀䤀开䨀漀礀猀琀椀挀欀䰀漀漀欀∀ऀ∀嘀椀猀琀愀 樀漀礀猀琀椀挀欀∀ഀഀ
"[english]GameUI_JoystickLook"	"Joystick look"਍∀䜀愀洀攀唀䤀开䨀漀礀猀琀椀挀欀䰀漀漀欀䰀愀戀攀氀∀ऀ∀唀猀愀爀 洀愀渀搀漀 瀀愀爀愀 洀椀爀愀爀 愀氀爀攀搀攀搀漀爀∀ഀഀ
"[english]GameUI_JoystickLookLabel"	"Use the gamepad to look around"਍∀䜀愀洀攀唀䤀开䨀漀礀猀琀椀挀欀䰀漀漀欀吀礀瀀攀∀ऀ∀吀椀瀀漀 搀攀 瘀椀猀琀愀∀ഀഀ
"[english]GameUI_JoystickLookType"	"Look type"਍∀䜀愀洀攀唀䤀开䨀漀礀猀琀椀挀欀一漀爀洀愀氀∀ऀ∀一漀爀洀愀氀∀ഀഀ
"[english]GameUI_JoystickNormal"	"Normal"਍∀䜀愀洀攀唀䤀开䨀漀礀猀琀椀挀欀䤀渀瘀攀爀琀攀搀∀ऀ∀䤀渀瘀攀爀琀椀搀愀∀ഀഀ
"[english]GameUI_JoystickInverted"	"Inverted"਍∀䜀愀洀攀唀䤀开䨀漀礀猀琀椀挀欀䴀漀瘀攀䰀漀漀欀匀琀椀挀欀猀∀ऀ∀匀琀椀挀欀猀 洀漀瘀攀爀⼀洀椀爀愀爀∀ऀ嬀␀圀䤀一㌀㈀崀ഀഀ
"[english]GameUI_JoystickMoveLookSticks"	"Move/Look sticks"਍∀䜀愀洀攀唀䤀开䨀漀礀猀琀椀挀欀䴀漀瘀攀䰀漀漀欀匀琀椀挀欀猀∀ऀ∀匀琀椀挀欀猀 愀渀愀氀最椀挀漀猀∀ऀ嬀␀堀㌀㘀　崀ഀഀ
"[english]GameUI_JoystickMoveLookSticks"	"Thumbsticks"਍∀䜀愀洀攀唀䤀开䨀漀礀猀琀椀挀欀匀漀甀琀栀瀀愀眀∀ऀ∀䤀渀琀攀爀挀愀洀戀椀愀爀 猀琀椀挀欀猀 攀渀 洀愀渀搀漀猀 搀攀 ㈀ 猀琀椀挀欀猀∀ऀ嬀␀圀䤀一㌀㈀崀ഀഀ
"[english]GameUI_JoystickSouthpaw"	"Swap sticks on dual-stick controllers"਍∀䜀愀洀攀唀䤀开䨀漀礀猀琀椀挀欀匀漀甀琀栀瀀愀眀∀ऀ∀䌀漀渀昀椀最甀爀愀挀椀渀 瀀愀爀愀 稀甀爀搀漀猀∀ऀ嬀␀堀㌀㘀　崀ഀഀ
"[english]GameUI_JoystickSouthpaw"	"Southpaw"਍∀䜀愀洀攀唀䤀开䨀漀礀猀琀椀挀欀䰀漀漀欀匀瀀攀攀搀倀椀琀挀栀∀ऀ∀匀攀渀猀椀戀椀氀椀搀愀搀 瘀攀爀琀椀挀愀氀∀ഀഀ
"[english]GameUI_JoystickLookSpeedPitch"	"Vertical sensitivity"਍∀䜀愀洀攀唀䤀开䨀漀礀猀琀椀挀欀䰀漀漀欀匀瀀攀攀搀夀愀眀∀ऀ∀匀攀渀猀椀戀椀氀椀搀愀搀 栀漀爀椀稀漀渀琀愀氀∀ഀഀ
"[english]GameUI_JoystickLookSpeedYaw"	"Horizontal sensitivity"਍∀䜀愀洀攀唀䤀开䨀漀礀猀琀椀挀欀䐀甀挀欀娀漀漀洀䴀漀搀攀∀ऀ∀䴀漀搀漀 愀最愀挀栀愀爀猀攀⼀稀漀漀洀∀ഀഀ
"[english]GameUI_JoystickDuckZoomMode"	"Duck/Zoom mode"਍∀䜀愀洀攀唀䤀开䨀漀礀猀琀椀挀欀䐀甀挀欀䴀漀搀攀∀ऀ∀䴀漀搀漀 愀最愀挀栀愀爀猀攀∀ഀഀ
"[english]GameUI_JoystickDuckMode"	"Duck mode"਍∀䜀愀洀攀唀䤀开䨀漀礀猀琀椀挀欀匀瀀爀椀渀琀䴀漀搀攀∀ऀ∀䌀愀爀爀攀爀愀 昀椀樀愀∀ഀഀ
"[english]GameUI_JoystickSprintMode"	"Sticky Sprint"਍∀䜀愀洀攀唀䤀开䄀甀琀漀䄀椀洀∀ऀ∀䄀甀琀漀愀瀀甀渀琀愀爀∀ഀഀ
"[english]GameUI_AutoAim"	"Auto-Aim"਍∀䜀愀洀攀唀䤀开䄀甀琀漀愀椀洀䰀愀戀攀氀∀ऀ∀䄀瀀甀渀琀愀 愀氀 攀渀攀洀椀最漀 愀甀琀漀洀琀椀挀愀洀攀渀琀攀⸀∀ഀഀ
"[english]GameUI_AutoaimLabel"	"Aims at enemies automatically."਍∀䜀愀洀攀唀䤀开䌀漀渀琀攀渀琀䰀漀挀欀∀ऀ∀䈀氀漀焀甀攀漀 挀漀渀琀攀渀椀搀漀∀ഀഀ
"[english]GameUI_ContentLock"	"Content lock"਍∀䜀愀洀攀唀䤀开䌀漀渀琀攀渀琀䰀漀挀欀䰀愀戀攀氀∀ऀ∀倀甀氀猀愀 攀猀琀攀 戀漀琀渀 攀 椀渀琀爀漀搀甀挀攀 氀愀 挀漀渀琀爀愀猀攀愀 瀀愀爀愀 搀攀猀愀挀琀椀瘀愀爀尀渀椀洀最攀渀攀猀 瀀漀挀漀 愀瀀爀漀瀀椀愀搀愀猀 瀀愀爀愀 氀漀猀 樀甀最愀搀漀爀攀猀 洀猀 樀瘀攀渀攀猀⸀∀ഀഀ
"[english]GameUI_ContentLockLabel"	"Press this button and enter password to disable\nvisuals inappropriate for younger players."਍∀䜀愀洀攀唀䤀开䌀漀渀琀攀渀琀匀琀愀琀甀猀䐀椀猀愀戀氀攀搀∀ऀ∀䤀渀琀爀漀搀甀挀攀 甀渀愀 挀漀渀琀爀愀猀攀愀 瀀愀爀愀 愀挀琀椀瘀愀爀 攀氀 戀氀漀焀甀攀漀⸀∀ഀഀ
"[english]GameUI_ContentStatusDisabled"	"Enter a password to enable the content lock."਍∀䜀愀洀攀唀䤀开䌀漀渀琀攀渀琀匀琀愀琀甀猀䔀渀愀戀氀攀搀∀ऀ∀䤀渀琀爀漀搀甀挀攀 甀渀愀 挀漀渀琀爀愀猀攀愀 瀀愀爀愀 搀攀猀愀挀琀椀瘀愀爀 攀氀 戀氀漀焀甀攀漀⸀∀ഀഀ
"[english]GameUI_ContentStatusEnabled"	"Enter a password to disable the content lock."਍∀䜀愀洀攀唀䤀开䔀渀愀戀氀攀∀ऀ∀䄀挀琀椀瘀愀爀∀ഀഀ
"[english]GameUI_Enable"	"Enable"਍∀䜀愀洀攀唀䤀开䐀椀猀愀戀氀攀∀ऀ∀䐀攀猀愀挀琀椀瘀愀爀∀ഀഀ
"[english]GameUI_Disable"	"Disable"਍∀䜀愀洀攀唀䤀开倀愀猀猀眀漀爀搀倀爀漀洀瀀琀∀ऀ∀䤀渀琀爀漀搀甀挀攀 甀渀愀 挀漀渀琀爀愀猀攀愀∀ഀഀ
"[english]GameUI_PasswordPrompt"	"Please enter a password"਍∀䜀愀洀攀唀䤀开倀愀猀猀眀漀爀搀䐀椀猀愀戀氀攀倀爀漀洀瀀琀∀ऀ∀䤀渀琀爀漀搀甀挀攀 挀漀渀琀爀愀猀攀愀∀ഀഀ
"[english]GameUI_PasswordDisablePrompt"	"Please enter password"਍∀䜀愀洀攀唀䤀开倀愀猀猀眀漀爀搀刀攀攀渀琀爀礀倀爀漀洀瀀琀∀ऀ∀刀攀椀渀琀爀漀搀甀挀攀 氀愀 挀漀渀琀爀愀猀攀愀∀ഀഀ
"[english]GameUI_PasswordReentryPrompt"	"Re-enter a password"਍∀䜀愀洀攀唀䤀开䌀愀渀挀攀氀∀ऀ∀䌀愀渀挀攀氀愀爀∀ഀഀ
"[english]GameUI_Cancel"	"Cancel"਍∀䜀愀洀攀唀䤀开䈀愀挀欀∀ऀ∀䄀琀爀猀∀ഀഀ
"[english]GameUI_Back"	"Back"਍∀䜀愀洀攀唀䤀开䄀瀀瀀氀礀∀ऀ∀䄀瀀氀椀挀愀爀∀ഀഀ
"[english]GameUI_Apply"	"Apply"਍∀䜀愀洀攀唀䤀开䐀攀洀漀倀氀愀礀攀爀∀ऀ∀䨀甀最愀搀漀爀 搀攀 搀攀洀漀∀ഀഀ
"[english]GameUI_DemoPlayer"	"Demo Player"਍∀䜀愀洀攀唀䤀开䰀漀愀搀䐀攀洀漀∀ऀ∀䔀氀椀最攀 愀爀挀栀椀瘀漀 搀攀 搀攀洀漀∀ഀഀ
"[english]GameUI_LoadDemo"	"Choose Demo File"਍∀䜀愀洀攀唀䤀开䰀漀愀搀∀ऀ∀䌀愀爀最愀爀∀ഀഀ
"[english]GameUI_Load"	"Load"਍∀䜀愀洀攀唀䤀开䐀攀洀漀䘀椀氀攀∀ऀ∀䄀爀挀栀椀瘀漀 搀攀 搀攀洀漀∀ഀഀ
"[english]GameUI_DemoFile"	"Demo File"਍∀䜀愀洀攀唀䤀开䴀愀瀀∀ऀ∀䴀愀瀀愀∀ഀഀ
"[english]GameUI_Map"	"Map"਍∀䜀愀洀攀唀䤀开䌀氀漀猀攀∀ऀ∀䌀攀爀爀愀爀∀ഀഀ
"[english]GameUI_Close"	"Close"਍∀䜀愀洀攀唀䤀开一攀瘀攀爀匀栀漀眀䈀甀琀琀漀渀∀ऀ∀一漀 瘀漀氀瘀攀爀 愀 洀漀猀琀爀愀爀 攀猀琀攀 搀椀氀漀最漀∀ഀഀ
"[english]GameUI_NeverShowButton"	"Do not show this dialog again"਍∀䜀愀洀攀唀䤀开䈀漀渀甀猀䴀愀瀀猀䠀攀氀瀀∀ऀ∀匀攀氀攀挀挀椀漀渀愀 甀渀 洀愀瀀愀 搀攀 戀漀渀椀昀椀挀愀挀椀渀 漀 甀渀 搀椀爀攀挀琀漀爀椀漀 礀 栀愀稀 挀氀椀挀 攀渀 ✀䌀愀爀最愀爀✀∀ഀഀ
"[english]GameUI_BonusMapsHelp"	"Select a bonus map or folder below, then click 'Load'"਍∀䜀愀洀攀唀䤀开䈀漀渀甀猀䴀愀瀀猀∀ऀ∀䴀䄀倀䄀匀 䐀䔀 䈀伀一䤀䘀䤀䌀䄀䌀䤀팀一∀ഀഀ
"[english]GameUI_BonusMaps"	"BONUS MAPS"਍∀䜀愀洀攀唀䤀开䈀漀渀甀猀䴀愀瀀猀䌀漀洀瀀氀攀琀椀漀渀∀ऀ∀吀攀爀洀椀渀愀搀漀∀ഀഀ
"[english]GameUI_BonusMapsCompletion"	"Complete"਍∀䜀愀洀攀唀䤀开䈀漀渀甀猀䴀愀瀀猀唀渀氀漀挀欀攀搀∀ऀ∀䈀漀渀椀昀椀挀愀挀椀渀 ⬀∀ഀഀ
"[english]GameUI_BonusMapsUnlocked"	"+Bonus"਍∀䜀愀洀攀唀䤀开䈀漀渀甀猀䴀愀瀀猀匀琀愀渀搀愀爀搀∀ऀ∀䔀猀琀渀搀愀爀∀ഀഀ
"[english]GameUI_BonusMapsStandard"	"Standard"਍∀䜀愀洀攀唀䤀开䈀漀渀甀猀䴀愀瀀猀䄀搀瘀愀渀挀攀搀∀ऀ∀䄀瘀愀渀稀愀搀愀猀∀ഀഀ
"[english]GameUI_BonusMapsAdvanced"	"Advanced"਍∀䜀愀洀攀唀䤀开䈀漀渀甀猀䴀愀瀀猀䈀攀猀琀∀ऀ∀䴀攀樀漀爀 爀攀猀甀氀琀愀搀漀㨀 ─猀㄀∀ഀഀ
"[english]GameUI_BonusMapsBest"	"Best: %s1"਍∀䜀愀洀攀唀䤀开䈀漀渀甀猀䴀愀瀀猀䜀漀愀氀∀ऀ∀伀戀樀攀琀椀瘀漀㨀 ─猀㄀∀ഀഀ
"[english]GameUI_BonusMapsGoal"	"Goal: %s1"਍∀䜀愀洀攀唀䤀开䰀漀愀搀䜀愀洀攀䠀攀氀瀀∀ऀ∀匀攀氀攀挀挀椀漀渀愀 甀渀愀 瀀愀爀琀椀搀愀 最甀愀爀搀愀搀愀 搀攀 攀猀琀愀 氀椀猀琀愀 礀 栀愀稀 挀氀椀挀 攀渀 ✀䌀愀爀最愀爀✀⸀∀ഀഀ
"[english]GameUI_LoadGameHelp"	"Select a saved game in the list below, then click 'Load game'."਍∀䜀愀洀攀唀䤀开䰀漀愀搀䜀愀洀攀∀ऀ∀䌀䄀刀䜀䄀刀 倀䄀刀吀䤀䐀䄀∀ഀഀ
"[english]GameUI_LoadGame"	"LOAD GAME"਍∀䜀愀洀攀唀䤀开䴀甀氀琀椀瀀氀愀礀攀爀䄀搀瘀愀渀挀攀搀∀ऀ∀伀倀䌀䤀伀一䔀匀 䴀唀䰀吀䤀䨀唀䜀䄀䐀伀刀 䄀嘀䄀一娀䄀䐀䄀匀∀ഀഀ
"[english]GameUI_MultiplayerAdvanced"	"MULTIPLAYER ADVANCED"਍∀䜀愀洀攀唀䤀开䴀甀氀琀椀瀀氀愀礀攀爀䌀甀猀琀漀洀椀稀攀∀ऀ∀倀攀爀猀漀渀愀氀椀稀愀爀 洀甀氀琀椀樀甀最愀搀漀爀∀ഀഀ
"[english]GameUI_MultiplayerCustomize"	"Multiplayer Customize"਍∀䜀愀洀攀唀䤀开䴀甀氀琀椀瀀氀愀礀攀爀∀ऀ∀䴀甀氀琀椀樀甀最愀搀漀爀∀ഀഀ
"[english]GameUI_Multiplayer"	"Multiplayer"਍∀䜀愀洀攀唀䤀开伀䬀∀ऀ∀䄀挀攀瀀琀愀爀∀ഀഀ
"[english]GameUI_OK"	"OK"਍∀䜀愀洀攀唀䤀开䄀搀瘀愀渀挀攀搀䔀氀氀椀瀀猀椀猀∀ऀ∀䄀瘀愀渀稀愀搀愀猀⸀⸀⸀∀ഀഀ
"[english]GameUI_AdvancedEllipsis"	"Advanced..."਍∀䜀愀洀攀唀䤀开䄀搀瘀愀渀挀攀搀一漀䔀氀氀椀瀀猀椀猀∀ऀ∀䄀瘀愀渀稀愀搀愀猀∀ഀഀ
"[english]GameUI_AdvancedNoEllipsis"	"Advanced"਍∀䜀愀洀攀唀䤀开倀氀愀礀攀爀一愀洀攀∀ऀ∀一漀洀戀爀攀 搀攀氀 樀甀最愀搀漀爀∀ഀഀ
"[english]GameUI_PlayerName"	"Player name"਍∀䜀愀洀攀唀䤀开倀爀椀洀愀爀礀䌀漀氀漀爀∀ऀ∀䌀漀氀漀爀 瀀爀椀洀愀爀椀漀∀ഀഀ
"[english]GameUI_PrimaryColor"	"Primary color"਍∀䜀愀洀攀唀䤀开匀攀挀漀渀搀愀爀礀䌀漀氀漀爀∀ऀ∀䌀漀氀漀爀 猀攀挀甀渀搀愀爀椀漀∀ഀഀ
"[english]GameUI_SecondaryColor"	"Secondary color"਍∀䜀愀洀攀唀䤀开䠀椀最栀䴀漀搀攀氀猀∀ऀ∀唀猀愀爀 洀漀搀攀氀漀猀 搀攀 愀氀琀愀 挀愀氀椀搀愀搀∀ഀഀ
"[english]GameUI_HighModels"	"Use high quality models"਍∀䜀愀洀攀唀䤀开倀氀愀礀攀爀䴀漀搀攀氀∀ऀ∀䴀漀搀攀氀漀 搀攀 樀甀最愀搀漀爀∀ഀഀ
"[english]GameUI_PlayerModel"	"Player model"਍∀䜀愀洀攀唀䤀开匀瀀爀愀礀瀀愀椀渀琀䤀洀愀最攀∀ऀ∀䤀洀愀最攀渀 瀀甀氀瘀攀爀椀稀愀搀愀∀ഀഀ
"[english]GameUI_SpraypaintImage"	"Spraypaint image"਍∀䜀愀洀攀唀䤀开匀瀀爀愀礀瀀愀椀渀琀匀攀爀瘀攀爀一漀琀攀∀ऀ∀䰀漀猀 挀愀洀戀椀漀猀 攀渀 琀甀 椀洀愀最攀渀 瀀甀氀瘀攀爀椀稀愀搀愀 琀攀渀搀爀渀 攀昀攀挀琀漀 愀氀 攀渀琀爀愀爀 愀 甀渀 猀攀爀瘀椀搀漀爀⸀∀ഀഀ
"[english]GameUI_SpraypaintServerNote"	"Changes to your spraypaint image take effect when you join a server."਍∀䜀愀洀攀唀䤀开一攀眀䜀愀洀攀∀ऀ∀一唀䔀嘀䄀 倀䄀刀吀䤀䐀䄀∀ഀഀ
"[english]GameUI_NewGame"	"NEW GAME"਍∀䜀愀洀攀唀䤀开一攀眀䜀愀洀攀䠀攀氀瀀吀攀砀琀∀ऀ∀匀攀氀攀挀挀椀漀渀愀 甀渀 渀椀瘀攀氀 搀攀 搀椀昀椀挀甀氀琀愀搀 漀 氀愀 猀愀氀愀 搀攀 攀渀琀爀攀渀愀洀椀攀渀琀漀尀渀礀 栀愀稀 挀氀椀挀 攀渀 ✀䨀甀最愀爀✀⸀∀ഀഀ
"[english]GameUI_NewGameHelpText"	"Select a level of difficulty or the Training\nroom, then click 'Play'."਍∀䜀愀洀攀唀䤀开吀爀愀椀渀椀渀最刀漀漀洀∀ऀ∀匀䄀䰀䄀 䐀䔀 䔀一吀刀䔀一䄀䴀䤀䔀一吀伀∀ഀഀ
"[english]GameUI_TrainingRoom"	"TRAINING ROOM"਍∀䜀愀洀攀唀䤀开䔀愀猀礀∀ऀ∀䘀挀椀氀∀ഀഀ
"[english]GameUI_Easy"	"Easy"਍∀䜀愀洀攀唀䤀开䴀攀搀椀甀洀∀ऀ∀䴀攀搀椀愀∀ഀഀ
"[english]GameUI_Medium"	"Medium"਍∀䜀愀洀攀唀䤀开䠀愀爀搀∀ऀ∀䐀椀昀挀椀氀∀ഀഀ
"[english]GameUI_Hard"	"Hard"਍∀䜀愀洀攀唀䤀开匀攀氀攀挀琀匀欀椀氀氀∀ऀ∀匀䔀䰀䔀䌀䌀䤀伀一䄀刀 䐀䤀䘀䤀䌀唀䰀吀䄀䐀 䐀䔀䰀 䌀伀䴀䈀䄀吀䔀∀ഀഀ
"[english]GameUI_SelectSkill"	"SELECT COMBAT DIFFICULTY"਍∀䜀愀洀攀唀䤀开匀琀愀爀琀一攀眀䜀愀洀攀∀ऀ∀䔀洀瀀攀稀愀爀 渀甀攀瘀愀∀ഀഀ
"[english]GameUI_StartNewGame"	"Start new game"਍∀䜀愀洀攀唀䤀开一攀砀琀∀ऀ∀䴀猀 㸀∀ഀഀ
"[english]GameUI_Next"	"More >"਍∀䜀愀洀攀唀䤀开倀爀攀瘀∀ऀ∀㰀 䴀猀∀ഀഀ
"[english]GameUI_Prev"	"< More"਍∀䜀愀洀攀唀䤀开倀氀愀礀∀ऀ∀䨀甀最愀爀∀ഀഀ
"[english]GameUI_Play"	"Play"਍∀䜀愀洀攀唀䤀开䔀渀愀戀氀攀䔀䄀堀∀ऀ∀䄀挀琀椀瘀愀爀 挀漀洀瀀愀琀椀戀椀氀椀搀愀搀 挀漀渀 䔀䄀堀∀ഀഀ
"[english]GameUI_EnableEAX"	"Enable EAX Hardware Support"਍∀䜀愀洀攀唀䤀开䔀渀愀戀氀攀䄀㌀䐀∀ऀ∀䄀挀琀椀瘀愀爀 挀漀洀瀀愀琀椀戀椀氀椀搀愀搀 挀漀渀 䄀㌀䐀∀ഀഀ
"[english]GameUI_EnableA3D"	"Enable A3D Hardware Support"਍∀䜀愀洀攀唀䤀开匀漀甀渀搀䔀昀昀攀挀琀嘀漀氀甀洀攀∀ऀ∀嘀漀氀甀洀攀渀 搀攀氀 樀甀攀最漀∀ഀഀ
"[english]GameUI_SoundEffectVolume"	"Game volume"਍∀䜀愀洀攀唀䤀开䠀䔀嘀匀甀椀琀嘀漀氀甀洀攀∀ऀ∀嘀漀氀甀洀攀渀 搀攀氀 琀爀愀樀攀 䠀䔀嘀∀ഀഀ
"[english]GameUI_HEVSuitVolume"	"HEV suit volume"਍∀䜀愀洀攀唀䤀开䴀倀㌀嘀漀氀甀洀攀∀ऀ∀嘀漀氀甀洀攀渀 䴀倀㌀ ⨀∀ഀഀ
"[english]GameUI_MP3Volume"	"MP3 volume *"਍∀䜀愀洀攀唀䤀开䴀甀猀椀挀嘀漀氀甀洀攀∀ऀ∀嘀漀氀甀洀攀渀 搀攀 氀愀 洀切猀椀挀愀∀ഀഀ
"[english]GameUI_MusicVolume"	"Music volume"਍∀䜀愀洀攀唀䤀开匀漀甀渀搀儀甀愀氀椀琀礀∀ऀ∀䌀愀氀椀搀愀搀 搀攀氀 猀漀渀椀搀漀∀ഀഀ
"[english]GameUI_SoundQuality"	"Sound quality"਍∀䜀愀洀攀唀䤀开唀氀琀爀愀∀ऀ∀䴀甀礀 愀氀琀愀∀ഀഀ
"[english]GameUI_Ultra"	"Very High"਍∀䜀愀洀攀唀䤀开䠀椀最栀∀ऀ∀䄀氀琀愀∀ഀഀ
"[english]GameUI_High"	"High"਍∀䜀愀洀攀唀䤀开䰀漀眀∀ऀ∀䈀愀樀愀∀ഀഀ
"[english]GameUI_Low"	"Low"਍∀䜀愀洀攀唀䤀开唀猀攀䐀攀昀愀甀氀琀猀∀ऀ∀倀爀攀搀攀昀椀渀椀搀愀猀∀ഀഀ
"[english]GameUI_UseDefaults"	"Use Defaults"਍∀䜀愀洀攀唀䤀开匀攀琀一攀眀䬀攀礀∀ऀ∀䔀搀椀琀愀爀∀ഀഀ
"[english]GameUI_SetNewKey"	"Edit key"਍∀䜀愀洀攀唀䤀开䌀氀攀愀爀䬀攀礀∀ऀ∀䈀漀爀爀愀爀∀ഀഀ
"[english]GameUI_ClearKey"	"Clear Key"਍∀䜀愀洀攀唀䤀开匀攀琀一攀眀䈀甀琀琀漀渀∀ऀ∀倀甀氀猀愀 甀渀 戀漀琀渀⸀⸀⸀∀ഀഀ
"[english]GameUI_SetNewButton"	"Press a button..."਍∀䜀愀洀攀唀䤀开䌀氀攀愀爀䈀甀琀琀漀渀∀ऀ∀䈀漀爀爀愀爀∀ഀഀ
"[english]GameUI_ClearButton"	"Clear"਍∀䜀愀洀攀唀䤀开䐀攀昀愀甀氀琀䈀甀琀琀漀渀猀∀ऀ∀䌀漀渀琀爀漀氀攀猀 瀀爀攀搀攀琀攀爀洀椀渀愀搀漀猀∀ഀഀ
"[english]GameUI_DefaultButtons"	"Default controls"਍∀䜀愀洀攀唀䤀开䄀挀琀椀漀渀∀ऀ∀䄀挀挀椀渀∀ഀഀ
"[english]GameUI_Action"	"Action"਍∀䜀愀洀攀唀䤀开吀漀最最氀攀∀ऀ∀䄀挀琀椀瘀愀爀⼀搀攀猀愀挀琀椀瘀愀爀∀ഀഀ
"[english]GameUI_Toggle"	"Toggle"਍∀䜀愀洀攀唀䤀开䠀漀氀搀∀ऀ∀䴀愀渀琀攀渀攀爀∀ഀഀ
"[english]GameUI_Hold"	"Hold"਍∀䜀愀洀攀唀䤀开䬀攀礀䈀甀琀琀漀渀∀ऀ∀吀䔀䌀䰀䄀⼀䈀伀吀팀一∀ഀഀ
"[english]GameUI_KeyButton"	"KEY/BUTTON"਍∀䜀愀洀攀唀䤀开䄀氀琀攀爀渀愀琀攀∀ऀ∀䄀䰀吀䔀刀一䄀刀∀ഀഀ
"[english]GameUI_Alternate"	"ALTERNATE"਍∀䜀愀洀攀唀䤀开圀椀渀搀漀眀攀搀∀ऀ∀䔀樀攀挀甀琀愀爀 攀渀 甀渀愀 瘀攀渀琀愀渀愀∀ഀഀ
"[english]GameUI_Windowed"	"Run in a window"਍∀䜀愀洀攀唀䤀开刀攀渀搀攀爀攀爀∀ऀ∀刀攀渀搀攀爀椀稀愀搀漀爀∀ഀഀ
"[english]GameUI_Renderer"	"Renderer"਍∀䜀愀洀攀唀䤀开匀漀昀琀眀愀爀攀∀ऀ∀匀漀昀琀眀愀爀攀∀ഀഀ
"[english]GameUI_Software"	"Software"਍∀䜀愀洀攀唀䤀开伀瀀攀渀䜀䰀∀ऀ∀伀瀀攀渀䜀䰀∀ഀഀ
"[english]GameUI_OpenGL"	"OpenGL"਍∀䜀愀洀攀唀䤀开䐀㌀䐀∀ऀ∀䐀㌀䐀∀ഀഀ
"[english]GameUI_D3D"	"D3D"਍∀䜀愀洀攀唀䤀开䈀爀椀最栀琀渀攀猀猀∀ऀ∀䈀爀椀氀氀漀∀ഀഀ
"[english]GameUI_Brightness"	"Brightness"਍∀䜀愀洀攀唀䤀开䜀愀洀洀愀∀ऀ∀䜀愀洀洀愀∀ഀഀ
"[english]GameUI_Gamma"	"Gamma"਍∀䜀愀洀攀唀䤀开刀攀猀漀氀甀琀椀漀渀∀ऀ∀刀攀猀漀氀甀挀椀渀∀ഀഀ
"[english]GameUI_Resolution"	"Resolution"਍∀䜀愀洀攀唀䤀开嘀椀搀攀漀刀攀猀琀愀爀琀∀ऀ∀一漀琀愀㨀 猀椀 挀愀洀戀椀愀猀 氀愀猀 漀瀀挀椀漀渀攀猀 搀攀 瘀搀攀漀Ⰰ 攀氀 樀甀攀最漀 猀攀 挀攀爀爀愀爀 礀 爀攀椀渀椀挀椀愀爀⸀∀ഀഀ
"[english]GameUI_VideoRestart"	"Note: changing video options will cause the game to exit and restart."਍∀䜀愀洀攀唀䤀开䔀渀愀戀氀攀嘀漀椀挀攀∀ऀ∀䄀挀琀椀瘀愀爀 瘀漀挀攀猀 攀渀 攀猀琀愀 瀀愀爀琀椀搀愀∀ഀഀ
"[english]GameUI_EnableVoice"	"Enable voice in this game"਍∀䜀愀洀攀唀䤀开䈀漀漀猀琀䴀椀挀爀漀瀀栀漀渀攀∀ऀ∀䄀甀洀⸀ 爀攀渀搀椀洀椀攀渀琀漀 搀攀 洀椀挀爀昀漀渀漀∀ഀഀ
"[english]GameUI_BoostMicrophone"	"Boost microphone gain"਍∀䜀愀洀攀唀䤀开䴀椀挀爀漀瀀栀漀渀攀嘀漀氀甀洀攀∀ऀ∀嘀漀氀甀洀攀渀 搀攀氀 洀椀挀爀昀漀渀漀∀ഀഀ
"[english]GameUI_MicrophoneVolume"	"Microphone Volume"਍∀䜀愀洀攀唀䤀开刀攀挀攀椀瘀攀嘀漀氀甀洀攀∀ऀ∀嘀漀氀甀洀攀渀 搀攀 爀攀挀攀瀀挀椀渀∀ഀഀ
"[english]GameUI_ReceiveVolume"	"Receive Volume"਍∀䜀愀洀攀唀䤀开吀攀猀琀䴀椀挀爀漀瀀栀漀渀攀∀ऀ∀倀爀漀戀愀爀 洀椀挀爀昀漀渀漀∀ഀഀ
"[english]GameUI_TestMicrophone"	"Test Microphone"਍∀䜀愀洀攀唀䤀开匀琀漀瀀吀攀猀琀䴀椀挀爀漀瀀栀漀渀攀∀ऀ∀䐀攀琀攀渀攀爀 瀀爀甀攀戀愀 搀攀氀 洀椀挀爀昀漀渀漀∀ഀഀ
"[english]GameUI_StopTestMicrophone"	"Stop Microphone Test"਍∀䜀愀洀攀唀䤀开嘀漀椀挀攀刀攀挀攀椀瘀攀嘀漀氀甀洀攀∀ऀ∀嘀漀氀⸀ 搀攀 爀攀挀攀瀀挀椀渀 搀攀 瘀漀稀 ⨀∀ഀഀ
"[english]GameUI_VoiceReceiveVolume"	"Voice receive volume *"਍∀䜀愀洀攀唀䤀开嘀漀椀挀攀吀爀愀渀猀洀椀琀嘀漀氀甀洀攀∀ऀ∀嘀漀氀⸀ 搀攀 琀爀愀渀猀洀椀猀椀渀 搀攀 瘀漀稀 ⨀∀ഀഀ
"[english]GameUI_VoiceTransmitVolume"	"Voice transmit volume *"਍∀䜀愀洀攀唀䤀开匀愀瘀攀䜀愀洀攀∀ऀ∀䜀唀䄀刀䐀䄀刀∀ഀഀ
"[english]GameUI_SaveGame"	"SAVE GAME"਍∀䜀愀洀攀唀䤀开匀愀瘀攀䜀愀洀攀䠀攀氀瀀∀ऀ∀匀攀氀攀挀挀椀漀渀愀 ✀一甀攀瘀愀 瀀愀爀琀椀搀愀 最甀愀爀搀愀搀愀✀ 瀀愀爀愀 挀爀攀愀爀 甀渀 愀爀挀栀椀瘀漀 渀甀攀瘀漀Ⰰ 漀 攀氀椀最攀尀渀甀渀愀 瀀愀爀琀椀搀愀 最甀愀爀搀愀搀愀 愀渀琀攀爀椀漀爀洀攀渀琀攀 瀀愀爀愀 猀漀戀爀攀猀挀爀椀戀椀爀 甀渀 愀爀挀栀椀瘀漀⸀∀ഀഀ
"[english]GameUI_SaveGameHelp"	"Select 'New Save Game' in the list to create a new file, or select\na previously saved game to overwrite a file."਍∀䜀愀洀攀唀䤀开䐀攀氀攀琀攀∀ऀ∀䔀氀椀洀椀渀愀爀∀ഀഀ
"[english]GameUI_Delete"	"Delete"਍∀䜀愀洀攀唀䤀开儀甀椀琀∀ऀ∀䄀戀愀渀搀漀渀愀爀∀ഀഀ
"[english]GameUI_Quit"	"Quit game"਍∀䜀愀洀攀唀䤀开匀琀攀愀洀倀愀猀猀眀漀爀搀∀ऀ∀䌀漀渀琀爀愀猀攀愀 匀琀攀愀洀∀ഀഀ
"[english]GameUI_SteamPassword"	"Steam Password"਍∀䜀愀洀攀唀䤀开䌀爀攀愀琀攀匀攀爀瘀攀爀∀ऀ∀䌀刀䔀䄀刀 匀䔀刀嘀䤀䐀伀刀∀ഀഀ
"[english]GameUI_CreateServer"	"CREATE SERVER"਍∀䜀愀洀攀唀䤀开匀琀愀爀琀∀ऀ∀䤀渀椀挀椀愀爀∀ഀഀ
"[english]GameUI_Start"	"Start"਍∀䜀愀洀攀唀䤀开䌀漀渀猀漀氀攀∀ऀ∀䌀漀渀猀漀氀愀∀ഀഀ
"[english]GameUI_Console"	"Console"਍∀䜀愀洀攀唀䤀开匀甀戀洀椀琀∀ऀ∀䔀渀瘀椀愀爀∀ഀഀ
"[english]GameUI_Submit"	"Submit"਍∀䜀愀洀攀唀䤀开伀瀀琀椀漀渀猀∀ऀ∀伀倀䌀䤀伀一䔀匀∀ഀഀ
"[english]GameUI_Options"	"OPTIONS"਍∀䜀愀洀攀唀䤀开䬀攀礀戀漀愀爀搀∀ऀ∀吀攀挀氀愀搀漀∀ഀഀ
"[english]GameUI_Keyboard"	"Keyboard"਍∀䜀愀洀攀唀䤀开䴀漀甀猀攀∀ऀ∀刀愀琀渀∀ഀഀ
"[english]GameUI_Mouse"	"Mouse"਍∀䜀愀洀攀唀䤀开䄀甀搀椀漀∀ऀ∀䄀甀搀椀漀∀ഀഀ
"[english]GameUI_Audio"	"Audio"਍∀䜀愀洀攀唀䤀开嘀椀搀攀漀∀ऀ∀嘀椀搀攀漀∀ഀഀ
"[english]GameUI_Video"	"Video"਍∀䜀愀洀攀唀䤀开嘀漀椀挀攀∀ऀ∀嘀漀稀∀ഀഀ
"[english]GameUI_Voice"	"Voice"਍∀䜀愀洀攀唀䤀开䄀搀瘀愀渀挀攀搀∀ऀ∀䈀氀漀焀甀攀漀∀ഀഀ
"[english]GameUI_Advanced"	"Lock"਍∀䜀愀洀攀唀䤀开匀攀爀瘀攀爀∀ऀ∀匀攀爀瘀椀搀漀爀∀ഀഀ
"[english]GameUI_Server"	"Server"਍∀䜀愀洀攀唀䤀开䜀愀洀攀∀ऀ∀䨀甀攀最漀∀ऀ嬀␀圀䤀一㌀㈀崀ഀഀ
"[english]GameUI_Game"	"Game"਍∀䜀愀洀攀唀䤀开匀愀瘀攀搀䜀愀洀攀∀ऀ∀倀愀爀琀椀搀愀 最甀愀爀搀愀搀愀∀ഀഀ
"[english]GameUI_SavedGame"	"Saved Game"਍∀䜀愀洀攀唀䤀开䔀氀愀瀀猀攀搀吀椀洀攀∀ऀ∀吀椀攀洀瀀漀 琀爀愀渀猀挀甀爀爀椀搀漀∀ഀഀ
"[english]GameUI_ElapsedTime"	"Elapsed Time"਍∀䜀愀洀攀唀䤀开吀椀洀攀匀琀愀洀瀀∀ऀ∀䴀愀爀挀愀 搀攀 琀椀攀洀瀀漀∀ഀഀ
"[english]GameUI_TimeStamp"	"Time Stamp"਍∀䜀愀洀攀唀䤀开䬀攀礀戀漀愀爀搀匀攀琀琀椀渀最猀∀ऀ∀倀愀爀洀攀琀爀漀猀 搀攀 琀攀挀氀愀搀漀∀ഀഀ
"[english]GameUI_KeyboardSettings"	"Keyboard settings"਍∀䜀愀洀攀唀䤀开䬀攀礀戀漀愀爀搀匀攀琀琀椀渀最猀吀攀砀琀∀ऀ∀뼀刀攀猀琀愀甀爀愀爀 琀攀挀氀愀猀 瀀爀攀搀攀琀攀爀洀椀渀愀搀愀猀 瀀愀爀愀 琀漀搀愀猀 氀愀猀 愀挀挀椀漀渀攀猀㼀∀ഀഀ
"[english]GameUI_KeyboardSettingsText"	"Reset all actions to use their default keys?"਍∀䜀愀洀攀唀䤀开䌀漀渀琀爀漀氀氀攀爀匀攀琀琀椀渀最猀吀攀砀琀∀ऀ∀뼀刀攀猀琀愀甀爀愀爀 琀漀搀愀猀 氀愀猀 漀瀀挀椀漀渀攀猀 瀀爀攀搀攀琀攀爀洀椀渀愀搀愀猀 搀攀氀 洀愀渀搀漀㼀∀ഀഀ
"[english]GameUI_ControllerSettingsText"	"Reset all controller options to their defaults?"਍∀䜀愀洀攀唀䤀开䜀愀洀攀䴀攀渀甀开一攀眀䜀愀洀攀∀ऀ∀一唀䔀嘀䄀 倀䄀刀吀䤀䐀䄀∀ഀഀ
"[english]GameUI_GameMenu_NewGame"	"NEW GAME"਍∀䜀愀洀攀唀䤀开䜀愀洀攀䴀攀渀甀开倀氀愀礀䐀攀洀漀∀ऀ∀䨀唀䜀䄀刀 䐀䔀䴀伀∀ഀഀ
"[english]GameUI_GameMenu_PlayDemo"	"PLAY DEMO"਍∀䜀愀洀攀唀䤀开䜀愀洀攀䴀攀渀甀开䈀漀渀甀猀䴀愀瀀猀∀ऀ∀䴀䄀倀䄀匀 䐀䔀 䈀伀一䤀䘀䤀䌀䄀䌀䤀팀一∀ഀഀ
"[english]GameUI_GameMenu_BonusMaps"	"BONUS MAPS"਍∀䜀愀洀攀唀䤀开䜀愀洀攀䴀攀渀甀开䰀漀愀搀䜀愀洀攀∀ऀ∀䌀䄀刀䜀䄀刀 倀䄀刀吀䤀䐀䄀∀ഀഀ
"[english]GameUI_GameMenu_LoadGame"	"LOAD GAME"਍∀䜀愀洀攀唀䤀开䜀愀洀攀䴀攀渀甀开匀愀瘀攀䜀愀洀攀∀ऀ∀䜀唀䄀刀䐀䄀刀∀ഀഀ
"[english]GameUI_GameMenu_SaveGame"	"SAVE GAME"਍∀䜀愀洀攀唀䤀开䜀愀洀攀䴀攀渀甀开䴀甀氀琀椀瀀氀愀礀攀爀∀ऀ∀䴀唀䰀吀䤀䨀唀䜀䄀䐀伀刀 ∀ഀഀ
"[english]GameUI_GameMenu_Multiplayer"	"MULTIPLAYER "਍∀䜀愀洀攀唀䤀开䜀愀洀攀䴀攀渀甀开䘀椀渀搀匀攀爀瘀攀爀猀∀ऀ∀䔀一䌀伀一吀刀䄀刀 匀䔀刀嘀䤀䐀伀刀䔀匀∀ഀഀ
"[english]GameUI_GameMenu_FindServers"	"FIND SERVERS"਍∀䜀愀洀攀唀䤀开䜀愀洀攀䴀攀渀甀开䘀爀椀攀渀搀猀∀ऀ∀䄀䴀䤀䜀伀匀∀ഀഀ
"[english]GameUI_GameMenu_Friends"	"FRIENDS"਍∀䜀愀洀攀唀䤀开䜀愀洀攀䴀攀渀甀开䌀甀猀琀漀洀椀稀攀∀ऀ∀倀䔀刀匀伀一䄀䰀䤀娀䄀刀∀ഀഀ
"[english]GameUI_GameMenu_Customize"	"CUSTOMIZE"਍∀䜀愀洀攀唀䤀开䜀愀洀攀䴀攀渀甀开䌀爀攀愀琀攀匀攀爀瘀攀爀∀ऀ∀䌀刀䔀䄀刀 匀䔀刀嘀䤀䐀伀刀∀ഀഀ
"[english]GameUI_GameMenu_CreateServer"	"CREATE SERVER"਍∀䜀愀洀攀唀䤀开䜀愀洀攀䴀攀渀甀开伀瀀琀椀漀渀猀∀ऀ∀伀倀䌀䤀伀一䔀匀∀ഀഀ
"[english]GameUI_GameMenu_Options"	"OPTIONS"਍∀䜀愀洀攀唀䤀开䜀愀洀攀䴀攀渀甀开䄀挀栀椀攀瘀攀洀攀渀琀猀∀ऀ∀䰀伀䜀刀伀匀∀ഀഀ
"[english]GameUI_GameMenu_Achievements"	"ACHIEVEMENTS"਍∀䜀愀洀攀唀䤀开䜀愀洀攀䴀攀渀甀开倀氀愀礀攀爀匀琀愀琀猀∀ऀ∀䔀匀吀䄀䐀촀匀吀䤀䌀䄀匀 䐀䔀 䨀唀䜀䄀䐀伀刀∀ഀഀ
"[english]GameUI_GameMenu_PlayerStats"	"PLAYER STATS"਍∀䜀愀洀攀唀䤀开䜀愀洀攀䴀攀渀甀开儀甀椀琀∀ऀ∀䄀䈀䄀一䐀伀一䄀刀 倀䄀刀吀䤀䐀䄀∀ഀഀ
"[english]GameUI_GameMenu_Quit"	"QUIT"਍∀䜀愀洀攀唀䤀开倀愀猀猀眀漀爀搀猀䐀漀渀琀䴀愀琀挀栀∀ऀ∀ꄀ䰀愀猀 挀漀渀琀爀愀猀攀愀猀 渀漀 挀漀椀渀挀椀搀攀渀℀∀ഀഀ
"[english]GameUI_PasswordsDontMatch"	"Entered passwords don't match!"਍∀䜀愀洀攀唀䤀开䴀甀猀琀䔀渀琀攀爀倀愀猀猀眀漀爀搀∀ऀ∀䐀攀戀攀猀 椀渀琀爀漀搀甀挀椀爀 甀渀愀 挀漀渀琀爀愀猀攀愀∀ഀഀ
"[english]GameUI_MustEnterPassword"	"You must enter a password"਍∀䜀愀洀攀唀䤀开䤀渀挀漀爀爀攀挀琀倀愀猀猀眀漀爀搀∀ऀ∀䌀漀渀琀爀愀猀攀愀 椀渀挀漀爀爀攀挀琀愀∀ഀഀ
"[english]GameUI_IncorrectPassword"	"Incorrect password"਍∀䜀愀洀攀唀䤀开䌀愀渀琀䐀椀猀愀戀氀攀䌀漀渀琀攀渀琀䌀琀爀氀∀ऀ∀一漀 猀攀 瀀甀攀搀攀 搀攀猀愀挀琀椀瘀愀爀Ⰰ 渀漀 猀攀 栀愀 攀猀琀愀戀氀攀挀椀搀漀 挀漀渀琀爀漀氀 搀攀 挀漀渀琀攀渀椀搀漀猀∀ഀഀ
"[english]GameUI_CantDisableContentCtrl"	"Can't disable, content control was not set"਍∀䜀愀洀攀唀䤀开䰀漀愀搀椀渀最∀ऀ∀䌀䄀刀䜀䄀一䐀伀⸀⸀⸀∀ഀഀ
"[english]GameUI_Loading"	"LOADING..."਍∀䜀愀洀攀唀䤀开䰀漀愀搀椀渀最䜀愀洀攀∀ऀ∀䌀䄀刀䜀䄀一䐀伀∀ഀഀ
"[english]GameUI_LoadingGame"	"LOADING"਍∀䜀愀洀攀唀䤀开䐀椀猀挀漀渀渀攀挀琀攀搀∀ऀ∀䐀攀猀挀漀渀攀挀琀愀搀漀∀ഀഀ
"[english]GameUI_Disconnected"	"Disconnected"਍∀䜀愀洀攀唀䤀开䌀漀渀渀攀挀琀椀漀渀䘀愀椀氀攀搀∀ऀ∀一漀 琀攀 栀愀猀 瀀漀搀椀搀漀 挀漀渀攀挀琀愀爀 愀氀 猀攀爀瘀椀搀漀爀⸀∀ഀഀ
"[english]GameUI_ConnectionFailed"	"Could not connect to server."਍∀䜀愀洀攀唀䤀开䐀椀猀挀漀渀渀攀挀琀攀搀䘀爀漀洀∀ऀ∀吀攀 栀愀猀 搀攀猀挀漀渀攀挀琀愀搀漀 搀攀氀 猀攀爀瘀椀搀漀爀⸀∀ഀഀ
"[english]GameUI_DisconnectedFrom"	"You have been disconnected from the server."਍∀䜀愀洀攀唀䤀开䐀椀猀挀漀渀渀攀挀琀攀搀䘀爀漀洀匀攀爀瘀攀爀䔀砀琀攀渀搀攀搀∀ऀ∀吀攀 栀愀猀 搀攀猀挀漀渀攀挀琀愀搀漀 搀攀氀 猀攀爀瘀椀搀漀爀⸀尀渀䴀漀琀椀瘀漀㨀 ─猀㄀∀ഀഀ
"[english]GameUI_DisconnectedFromServerExtended"	"You have been disconnected from the server.\nReason: %s1"਍∀䜀愀洀攀唀䤀开䔀猀琀愀戀氀椀猀栀椀渀最䌀漀渀渀攀挀琀椀漀渀∀ऀ∀䔀猀琀愀戀氀攀挀椀攀渀搀漀 挀漀渀攀砀椀渀 搀攀 爀攀搀 愀氀 猀攀爀瘀椀搀漀爀⸀⸀⸀∀ഀഀ
"[english]GameUI_EstablishingConnection"	"Establishing network connection to server..."਍∀䜀愀洀攀唀䤀开倀愀爀猀攀匀攀爀瘀攀爀䤀渀昀漀∀ऀ∀䄀渀愀氀椀稀愀渀搀漀 椀渀昀漀爀洀愀挀椀渀 搀攀氀 猀攀爀瘀椀搀漀爀⸀⸀⸀∀ഀഀ
"[english]GameUI_ParseServerInfo"	"Parsing server info..."਍∀䜀愀洀攀唀䤀开䌀栀攀挀欀䌀刀䌀猀∀ऀ∀嘀愀氀椀搀愀渀搀漀 爀攀挀甀爀猀漀猀 搀攀 氀愀 瀀愀爀琀椀搀愀⸀⸀⸀∀ഀഀ
"[english]GameUI_CheckCRCs"	"Validating game resources..."਍∀䜀愀洀攀唀䤀开倀爀攀挀愀挀栀攀刀攀猀漀甀爀挀攀猀∀ऀ∀䌀愀爀最愀渀搀漀 爀攀挀甀爀猀漀猀 搀攀氀 樀甀攀最漀⸀⸀⸀∀ഀഀ
"[english]GameUI_PrecacheResources"	"Loading game resources..."਍∀䜀愀洀攀唀䤀开倀愀爀猀攀䈀愀猀攀氀椀渀攀∀ऀ∀䄀渀愀氀椀稀愀渀搀漀 椀渀昀漀爀洀愀挀椀渀 搀攀 氀愀 瀀愀爀琀椀搀愀⸀⸀⸀∀ഀഀ
"[english]GameUI_ParseBaseline"	"Parsing game info..."਍∀䜀愀洀攀唀䤀开匀琀愀爀琀椀渀最匀攀爀瘀攀爀∀ऀ∀䤀渀椀挀椀愀渀搀漀 猀攀爀瘀椀搀漀爀 搀攀 瀀愀爀琀椀搀愀 氀漀挀愀氀⸀⸀⸀∀ഀഀ
"[english]GameUI_StartingServer"	"Starting local game server..."਍∀䜀愀洀攀唀䤀开䐀椀猀瀀氀愀礀䴀漀搀攀∀ऀ∀䴀漀搀漀 搀攀 瀀爀攀猀攀渀琀愀挀椀渀∀ഀഀ
"[english]GameUI_DisplayMode"	"Display mode"਍∀䜀愀洀攀唀䤀开䘀甀氀氀猀挀爀攀攀渀∀ऀ∀倀愀渀琀愀氀氀愀 挀漀洀瀀氀攀琀愀∀ഀഀ
"[english]GameUI_Fullscreen"	"Full screen"਍∀䜀愀洀攀唀䤀开䄀猀瀀攀挀琀刀愀琀椀漀∀ऀ∀刀攀氀愀挀椀渀 搀攀 愀猀瀀攀挀琀漀∀ഀഀ
"[english]GameUI_AspectRatio"	"Aspect Ratio"਍∀䜀愀洀攀唀䤀开䄀猀瀀攀挀琀一漀爀洀愀氀∀ऀ∀一漀爀洀愀氀 ⠀㐀㨀㌀⤀∀ഀഀ
"[english]GameUI_AspectNormal"	"Normal (4:3)"਍∀䜀愀洀攀唀䤀开䄀猀瀀攀挀琀圀椀搀攀㄀㘀砀㤀∀ऀ∀倀愀渀漀爀洀椀挀愀 ㄀㘀㨀㤀∀ഀഀ
"[english]GameUI_AspectWide16x9"	"Widescreen 16:9"਍∀䜀愀洀攀唀䤀开䄀猀瀀攀挀琀圀椀搀攀㄀㘀砀㄀　∀ऀ∀倀愀渀漀爀洀椀挀愀 ㄀㘀㨀㄀　∀ഀഀ
"[english]GameUI_AspectWide16x10"	"Widescreen 16:10"਍∀䜀愀洀攀唀䤀开䄀猀瀀攀挀琀圀椀搀攀∀ऀ∀倀愀渀琀愀氀氀愀 瀀愀渀漀爀洀椀挀愀∀ഀഀ
"[english]GameUI_AspectWide"	"Widescreen"਍∀䜀愀洀攀唀䤀开䌀䐀䬀攀礀∀ऀ∀䌀氀愀瘀攀 搀攀 瀀爀漀搀甀挀琀漀∀ഀഀ
"[english]GameUI_CDKey"	"CD Key"਍∀䜀愀洀攀唀䤀开䔀渀琀攀爀䌀䐀䬀攀礀∀ऀ∀倀漀爀 昀愀瘀漀爀Ⰰ 椀渀琀爀漀搀甀挀攀 氀愀 挀氀愀瘀攀 搀攀 瀀爀漀搀甀挀琀漀 焀甀攀尀渀昀椀最甀爀愀 椀洀瀀爀攀猀愀 攀渀 氀愀 挀愀爀琀甀氀愀 搀攀 琀甀 䌀䐀⸀∀ഀഀ
"[english]GameUI_EnterCDKey"	"Please enter your CD Key, which can be\nfound printed on your CD jewel case."਍∀䜀愀洀攀唀䤀开䰀漀愀搀椀渀最䐀椀愀氀漀最开䌀漀渀琀攀渀琀䠀漀猀琀椀渀最∀ऀ∀䄀渀昀椀琀爀椀渀 搀攀 挀漀渀琀攀渀椀搀漀㨀∀ഀഀ
"[english]GameUI_LoadingDialog_ContentHosting"	"Content hosting provided by:"਍∀䜀愀洀攀唀䤀开䌀漀氀漀爀匀氀椀搀攀爀猀∀ऀ∀䌀漀氀漀爀攀猀∀ഀഀ
"[english]GameUI_ColorSliders"	"Colors"਍∀䜀愀洀攀唀䤀开䌀漀氀漀爀儀甀愀氀椀琀礀∀ऀ∀䌀愀氀椀搀愀搀 搀攀氀 挀漀氀漀爀∀ഀഀ
"[english]GameUI_ColorQuality"	"Color Quality"਍∀䜀愀洀攀唀䤀开䌀䐀䬀攀礀开䤀渀瘀愀氀椀搀开吀攀砀琀∀ऀ∀䰀愀 挀氀愀瘀攀 搀攀 瀀爀漀搀甀挀琀漀 焀甀攀 栀愀猀 椀渀琀爀漀搀甀挀椀搀漀 渀漀 攀猀 瘀氀椀搀愀⸀∀ഀഀ
"[english]GameUI_CDKey_Invalid_Text"	"The CD Key you have entered is invalid."਍∀䜀愀洀攀唀䤀开䌀䐀䬀攀礀开䤀渀瘀愀氀椀搀开吀椀琀氀攀∀ऀ∀䌀䰀䄀嘀䔀 䐀䔀 倀刀伀䐀唀䌀吀伀 䤀一䌀伀刀刀䔀䌀吀䄀∀ഀഀ
"[english]GameUI_CDKey_Invalid_Title"	"INCORRECT CD KEY"਍∀䜀愀洀攀唀䤀开䌀䐀䬀攀礀开吀漀漀䴀愀渀礀吀爀椀攀猀∀ऀ∀䠀愀猀 椀渀琀爀漀搀甀挀椀搀漀 甀渀愀 挀氀愀瘀攀 搀攀 瀀爀漀搀甀挀琀漀 椀渀挀漀爀爀攀挀琀愀 爀攀瀀攀琀椀搀愀猀 瘀攀挀攀猀⸀ 匀愀氀椀攀渀搀漀⸀⸀⸀∀ഀഀ
"[english]GameUI_CDKey_TooManyTries"	"Incorrect CD Key entered too many times. Exiting..."਍∀䜀愀洀攀唀䤀开䜀愀洀攀䴀攀渀甀开刀攀猀甀洀攀䜀愀洀攀∀ऀ∀䌀伀一吀䤀一唀䄀刀 倀䄀刀吀䤀䐀䄀∀ഀഀ
"[english]GameUI_GameMenu_ResumeGame"	"RESUME GAME"਍∀䜀愀洀攀唀䤀开䜀愀洀攀䴀攀渀甀开䐀椀猀挀漀渀渀攀挀琀∀ऀ∀䐀䔀匀䌀伀一䔀䌀吀䄀刀∀ഀഀ
"[english]GameUI_GameMenu_Disconnect"	"DISCONNECT"਍∀䜀愀洀攀唀䤀开䜀愀洀攀䴀攀渀甀开䌀栀愀渀最攀䜀愀洀攀∀ऀ∀䌀䄀䴀䈀䤀䄀刀 倀䄀刀吀䤀䐀䄀∀ഀഀ
"[english]GameUI_GameMenu_ChangeGame"	"CHANGE GAME"਍∀䜀愀洀攀唀䤀开䜀愀洀攀䴀攀渀甀开倀氀愀礀攀爀䰀椀猀琀∀ऀ∀匀䤀䰀䔀一䌀䤀䄀刀 䨀唀䜀䄀䐀伀刀䔀匀∀ഀഀ
"[english]GameUI_GameMenu_PlayerList"	"MUTE PLAYERS"਍∀䜀愀洀攀唀䤀开伀甀琀伀昀䐀愀琀攀开吀椀琀氀攀∀ऀ∀倀䄀刀吀䤀䐀䄀 伀䈀匀伀䰀䔀吀䄀∀ഀഀ
"[english]GameUI_OutOfDate_Title"	"GAME IS OUT OF DATE"਍∀䜀愀洀攀唀䤀开伀甀琀伀昀䐀愀琀攀开唀刀䰀∀ऀ∀栀琀琀瀀㨀⼀⼀眀眀眀⸀猀琀攀愀洀瀀漀眀攀爀攀搀⸀挀漀洀⼀愀甀琀漀甀瀀搀愀琀攀∀ഀഀ
"[english]GameUI_OutOfDate_URL"	"http://www.steampowered.com/autoupdate"਍∀䜀愀洀攀唀䤀开伀甀琀伀昀䐀愀琀攀开䴀猀最∀ऀ∀䔀氀 樀甀攀最漀 渀漀 攀猀琀 愀挀琀甀愀氀椀稀愀搀漀⸀尀渀䠀愀稀 挀氀椀挀 攀渀 䄀挀攀瀀琀愀爀 瀀愀爀愀 椀爀 愀 氀愀 瀀最椀渀愀 圀攀戀 搀攀 嘀愀氀瘀攀 礀 搀攀猀挀愀爀最愀爀 氀愀猀 切氀琀椀洀愀猀 愀挀琀甀愀氀椀稀愀挀椀漀渀攀猀⸀∀ഀഀ
"[english]GameUI_OutOfDate_Msg"	"Your game is out of date.\nClick OK to go to Valve's webpage to download the latest updates."਍∀䜀愀洀攀唀䤀开儀甀椀琀䌀漀渀昀椀爀洀愀琀椀漀渀吀椀琀氀攀∀ऀ∀䄀䈀䄀一䐀伀一䄀刀∀ഀഀ
"[english]GameUI_QuitConfirmationTitle"	"QUIT GAME"਍∀䜀愀洀攀唀䤀开儀甀椀琀䌀漀渀昀椀爀洀愀琀椀漀渀吀攀砀琀∀ऀ∀뼀儀甀椀攀爀攀猀 猀愀氀椀爀 搀攀氀 樀甀攀最漀 愀栀漀爀愀㼀∀ഀഀ
"[english]GameUI_QuitConfirmationText"	"Do you wish to stop playing now?"਍∀䜀愀洀攀唀䤀开䐀椀猀挀漀渀渀攀挀琀∀ऀ∀䐀攀猀挀漀渀攀挀琀愀爀∀ഀഀ
"[english]GameUI_Disconnect"	"Disconnect"਍∀䜀愀洀攀唀䤀开䐀椀猀挀漀渀渀攀挀琀䌀漀渀昀椀爀洀愀琀椀漀渀吀攀砀琀∀ऀ∀뼀匀攀最甀爀漀 焀甀攀 搀攀猀攀愀猀 愀戀愀渀搀漀渀愀爀 攀猀琀愀 瀀愀爀琀椀搀愀㼀∀ഀഀ
"[english]GameUI_DisconnectConfirmationText"	"Are you sure you want to leave this game?"਍∀䜀愀洀攀唀䤀开䐀椀猀挀漀渀渀攀挀琀䠀漀猀琀䌀漀渀昀椀爀洀愀琀椀漀渀吀攀砀琀∀ऀ∀匀椀 琀攀 搀攀猀挀漀渀攀挀琀愀猀Ⰰ 攀砀瀀甀氀猀愀爀猀 愀 琀漀搀漀猀 氀漀猀 樀甀最愀搀漀爀攀猀⸀ 뼀䔀猀琀猀 猀攀最甀爀漀 搀攀 焀甀攀 搀攀猀攀愀猀 愀戀愀渀搀漀渀愀爀 攀猀琀愀 瀀愀爀琀椀搀愀㼀∀ഀഀ
"[english]GameUI_DisconnectHostConfirmationText"	"Disconnecting will kick all players. Are you sure you want to leave this game?"਍∀䜀愀洀攀唀䤀开䌀栀愀渀最攀䜀愀洀攀∀ऀ∀䌀愀洀戀椀愀爀 瀀愀爀琀椀搀愀∀ഀഀ
"[english]GameUI_ChangeGame"	"Change game"਍∀䜀愀洀攀唀䤀开一漀伀琀栀攀爀䜀愀洀攀猀䄀瘀愀椀氀愀戀氀攀∀ऀ∀一漀 栀愀礀 渀椀渀最甀渀愀 漀琀爀愀 瀀愀爀琀椀搀愀 搀椀猀瀀漀渀椀戀氀攀⸀∀ഀഀ
"[english]GameUI_NoOtherGamesAvailable"	"There are no other games available to play."਍∀䜀愀洀攀唀䤀开䘀漀爀挀攀䜀愀洀攀刀攀猀琀愀爀琀∀ऀ∀䄀氀 挀愀洀戀椀愀爀 搀攀 樀甀攀最漀Ⰰ 猀攀 爀攀椀渀椀挀椀愀爀 攀氀 猀椀猀琀攀洀愀⸀∀ഀഀ
"[english]GameUI_ForceGameRestart"	"Changing games will cause the engine to restart."਍∀䜀愀洀攀唀䤀开䴀椀氀攀猀开嘀漀椀挀攀∀ऀ∀唀猀愀 䴀椀氀攀猀 匀漀甀渀搀 匀礀猀琀攀洀⸀ 䌀漀瀀礀爀椀最栀琀 ꤀ ㄀㤀㤀㄀ⴀ㈀　　㄀ 搀攀 刀䄀䐀 䜀愀洀攀 吀漀漀氀猀Ⰰ 䤀渀挀⸀∀ഀഀ
"[english]GameUI_Miles_Voice"	"Uses Miles Sound System. Copyright © 1991-2001 by RAD Game Tools, Inc."਍∀䜀愀洀攀唀䤀开䴀椀氀攀猀开䄀甀搀椀漀∀ऀ∀䰀攀挀琀甀爀愀 搀攀 愀爀挀栀椀瘀漀猀 䴀倀䔀䜀 䰀愀礀攀爀ⴀ㌀ 瀀爀漀瀀漀爀挀椀漀渀愀搀愀 挀漀渀 攀氀 猀椀猀琀攀洀愀 䴀椀氀攀猀 匀漀甀渀搀 匀礀猀琀攀洀 搀攀 刀䄀䐀 䜀愀洀攀 吀漀漀氀猀Ⰰ 䤀渀挀⸀ 吀攀挀渀漀氀漀最愀 搀攀 挀漀洀瀀爀攀猀椀渀 搀攀 愀甀搀椀漀 䴀倀䔀䜀 䰀愀礀攀爀ⴀ㌀ 挀漀渀 氀椀挀攀渀挀椀愀 搀攀 䘀爀愀甀渀栀漀昀攀爀 䤀䤀匀 礀 吀䠀伀䴀匀伀一 洀甀氀琀椀洀攀搀椀愀⸀∀ഀഀ
"[english]GameUI_Miles_Audio"	"MPEG Layer-3 playback supplied with the Miles Sound System from RAD Game Tools, Inc. MPEG Layer-3 audio compression technology licensed by Fraunhofer IIS and THOMSON multimedia."਍∀䜀愀洀攀唀䤀开䈀椀渀欀∀ऀ∀唀猀愀 䈀椀渀欀 嘀椀搀攀漀⸀ 䌀漀瀀礀爀椀最栀琀 ꤀ ㄀㤀㤀㜀ⴀ㈀　　㜀 搀攀 刀䄀䐀 䜀愀洀攀 吀漀漀氀猀Ⰰ 䤀渀挀⸀∀ഀഀ
"[english]GameUI_Bink"	"Uses Bink Video. Copyright © 1997-2007 by RAD Game Tools, Inc."਍∀䜀愀洀攀唀䤀开䴀甀琀攀䤀渀最愀洀攀嘀漀椀挀攀∀ऀ∀匀椀氀攀渀挀椀愀爀∀ഀഀ
"[english]GameUI_MuteIngameVoice"	"Mute in-game voice"਍∀䜀愀洀攀唀䤀开唀渀洀甀琀攀䤀渀最愀洀攀嘀漀椀挀攀∀ऀ∀䄀挀琀椀瘀愀爀 瘀漀挀攀猀 搀甀爀愀渀琀攀 氀愀 瀀愀爀琀椀搀愀∀ഀഀ
"[english]GameUI_UnmuteIngameVoice"	"Unmute in-game voice"਍∀䜀愀洀攀唀䤀开倀氀愀礀攀爀䰀椀猀琀䐀椀愀氀漀最吀椀琀氀攀∀ऀ∀䨀唀䜀䄀䐀伀刀䔀匀 䄀䌀吀唀䄀䰀䔀匀 ⴀ ─猀攀爀瘀攀爀─∀ഀഀ
"[english]GameUI_PlayerListDialogTitle"	"CURRENT PLAYERS - %server%"਍∀䜀愀洀攀唀䤀开䘀爀椀攀渀搀猀一愀洀攀∀ऀ∀一漀洀戀爀攀 搀攀氀 愀洀椀最漀∀ഀഀ
"[english]GameUI_FriendsName"	"Friends name"਍∀䜀愀洀攀唀䤀开倀爀漀瀀攀爀琀椀攀猀∀ऀ∀倀爀漀瀀椀攀搀愀搀攀猀∀ഀഀ
"[english]GameUI_Properties"	"Properties"਍∀䜀愀洀攀唀䤀开䄀搀搀䘀爀椀攀渀搀吀椀琀氀攀∀ऀ∀䄀䴀䤀䜀伀匀 ⴀ 䄀턀䄀䐀䤀刀 䄀䴀䤀䜀伀∀ഀഀ
"[english]GameUI_AddFriendTitle"	"FRIENDS - ADD FRIEND"਍∀䜀愀洀攀唀䤀开䘀爀椀攀渀搀䄀搀搀攀搀吀漀䰀椀猀琀∀ऀ∀匀攀 栀愀 愀愀搀椀搀漀 ─渀愀洀攀─ 愀 琀甀 氀椀猀琀愀 搀攀 愀洀椀最漀猀⸀尀渀吀攀渀 攀渀 挀甀攀渀琀愀 焀甀攀 渀漀 猀攀 洀漀猀琀爀愀爀渀 攀渀 氀渀攀愀 栀愀猀琀愀 焀甀攀 栀愀礀愀渀 愀挀攀瀀琀愀搀漀 琀甀 猀漀氀椀挀椀琀甀搀 搀攀 愀洀椀最漀猀⸀∀ഀഀ
"[english]GameUI_FriendAddedToList"	"%name% has been added to your friends list.\nNote that they will not show up as online until they have accepted your friendship request."਍∀䜀愀洀攀唀䤀开䄀搀搀䘀爀椀攀渀搀䘀愀椀氀攀搀∀ऀ∀一漀 猀攀 栀愀 瀀漀搀椀搀漀 愀愀搀椀爀 愀 ─渀愀洀攀─ 愀 琀甀 氀椀猀琀愀⸀尀渀匀攀 栀愀 瀀爀漀搀甀挀椀搀漀 甀渀 攀爀爀漀爀 搀攀 挀漀渀攀砀椀渀Ⰰ 漀 渀漀 猀攀 攀猀琀 攀樀攀挀甀琀愀渀搀漀 䄀洀椀最漀猀⸀∀ഀഀ
"[english]GameUI_AddFriendFailed"	"%name% could not be added to your list.\nThere was either a connection error, or they are not running Friends."਍∀䜀愀洀攀唀䤀开一漀伀琀栀攀爀倀氀愀礀攀爀猀䤀渀䜀愀洀攀∀ऀ∀一漀 栀愀礀 漀琀爀漀猀 樀甀最愀搀漀爀攀猀 攀渀 氀愀 瀀愀爀琀椀搀愀⸀∀ഀഀ
"[english]GameUI_NoOtherPlayersInGame"	"There are no other players in the game."਍∀䜀愀洀攀唀䤀开儀甀椀挀欀匀愀瘀攀∀ऀ∀䜀唀䄀刀䐀䄀䐀伀 刀섀倀䤀䐀伀∀ഀഀ
"[english]GameUI_QuickSave"	"QUICK SAVE"਍∀䜀愀洀攀唀䤀开䄀甀琀漀匀愀瘀攀∀ऀ∀䜀唀䄀刀䐀䄀䐀伀 䄀唀吀伀䴀섀吀䤀䌀伀∀ഀഀ
"[english]GameUI_AutoSave"	"AUTO SAVE"਍∀䜀愀洀攀唀䤀开䄀甀琀漀匀愀瘀攀䰀愀戀攀氀∀ऀ∀䄀唀吀伀䴀섀吀䤀䌀䄀㨀∀ഀഀ
"[english]GameUI_AutoSaveLabel"	"AUTO:"਍∀䜀愀洀攀唀䤀开唀猀攀爀匀愀瘀攀䰀愀戀攀氀∀ऀ∀唀匀唀䄀刀䤀伀㨀∀ഀഀ
"[english]GameUI_UserSaveLabel"	"USER:"਍∀䜀愀洀攀唀䤀开吀礀瀀攀∀ऀ∀吀椀瀀漀∀ഀഀ
"[english]GameUI_Type"	"Type"਍∀䜀愀洀攀唀䤀开匀攀爀瘀攀爀一愀洀攀∀ऀ∀一漀洀戀爀攀 搀攀氀 猀攀爀瘀椀搀漀爀∀ഀഀ
"[english]GameUI_ServerName"	"Server name"਍∀䜀愀洀攀唀䤀开䴀愀砀倀氀愀礀攀爀猀∀ऀ∀一먀 洀砀⸀ 樀甀最愀搀漀爀攀猀㨀∀ഀഀ
"[english]GameUI_MaxPlayers"	"Max. Players:"਍∀䜀愀洀攀唀䤀开倀愀猀猀眀漀爀搀∀ऀ∀䌀漀渀琀爀愀猀攀愀∀ഀഀ
"[english]GameUI_Password"	"Password"਍∀䜀愀洀攀唀䤀开䐀䄀刀䬀∀ऀ∀伀匀䌀唀刀伀∀ഀഀ
"[english]GameUI_DARK"	"DARK"਍∀䜀愀洀攀唀䤀开䰀䤀䜀䠀吀∀ऀ∀䌀䰀䄀刀伀∀ഀഀ
"[english]GameUI_LIGHT"	"LIGHT"਍∀䜀愀洀攀唀䤀开嘀攀爀椀昀礀椀渀最刀攀猀漀甀爀挀攀猀∀ऀ∀䌀漀洀瀀爀漀戀愀渀搀漀 爀攀挀甀爀猀漀猀⸀⸀⸀∀ഀഀ
"[english]GameUI_VerifyingResources"	"Verifying resources..."਍∀䜀愀洀攀唀䤀开嘀攀爀椀昀礀椀渀最䄀渀搀䐀漀眀渀氀漀愀搀椀渀最∀ऀ∀䌀漀洀瀀爀漀戀愀渀搀漀 礀 搀攀猀挀愀爀最愀渀搀漀 爀攀挀甀爀猀漀猀⸀⸀⸀∀ഀഀ
"[english]GameUI_VerifyingAndDownloading"	"Verifying and downloading resources..."਍∀䜀愀洀攀唀䤀开唀瀀搀愀琀椀渀最匀琀攀愀洀刀攀猀漀甀爀挀攀猀∀ऀ∀䄀挀琀甀愀氀椀稀愀渀搀漀 爀攀挀甀爀猀漀猀 搀攀 匀琀攀愀洀∀ഀഀ
"[english]GameUI_UpdatingSteamResources"	"Updating steam resources"਍∀䜀愀洀攀唀䤀开䐀漀眀渀氀漀愀搀䘀愀椀氀攀搀∀ऀ∀一漀 猀攀 栀愀 瀀漀搀椀搀漀 搀攀猀挀愀爀最愀爀 ─猀㄀∀ഀഀ
"[english]GameUI_DownloadFailed"	"Could not download %s1"਍∀䜀愀洀攀唀䤀开䐀漀眀渀氀漀愀搀䘀愀椀氀攀搀娀攀爀漀䰀攀渀∀ऀ∀一漀 猀攀 栀愀 瀀漀搀椀搀漀 搀攀猀挀愀爀最愀爀 ─猀㄀㨀尀渀䔀氀 愀爀挀栀椀瘀漀 渀漀 琀椀攀渀攀 搀愀琀漀猀∀ഀഀ
"[english]GameUI_DownloadFailedZeroLen"	"Could not download %s1:\nFile has no data"਍∀䜀愀洀攀唀䤀开䐀漀眀渀氀漀愀搀䘀愀椀氀攀搀䌀漀渀䌀氀漀猀攀搀∀ऀ∀一漀 猀攀 栀愀 瀀漀搀椀搀漀 搀攀猀挀愀爀最愀爀 ─猀㄀㨀尀渀䌀漀渀攀砀椀渀 挀攀爀爀愀搀愀 瀀漀爀 愀渀昀椀琀爀椀渀 爀攀洀漀琀漀∀ഀഀ
"[english]GameUI_DownloadFailedConClosed"	"Could not download %s1:\nConnection closed by remote host"਍∀䜀愀洀攀唀䤀开䐀漀眀渀氀漀愀搀䘀愀椀氀攀搀䈀愀搀唀刀䰀∀ऀ∀一漀 猀攀 栀愀 瀀漀搀椀搀漀 搀攀猀挀愀爀最愀爀 ─猀㄀㨀尀渀唀刀䰀 渀漀 瘀氀椀搀愀∀ഀഀ
"[english]GameUI_DownloadFailedBadURL"	"Could not download %s1:\nInvalid URL"਍∀䜀愀洀攀唀䤀开䐀漀眀渀氀漀愀搀䘀愀椀氀攀搀䈀愀搀倀爀漀琀漀挀漀氀∀ऀ∀一漀 猀攀 栀愀 瀀漀搀椀搀漀 搀攀猀挀愀爀最愀爀 ─猀㄀㨀尀渀匀漀氀漀 攀猀 挀漀洀瀀愀琀椀戀氀攀 挀漀渀 䠀吀吀倀∀ഀഀ
"[english]GameUI_DownloadFailedBadProtocol"	"Could not download %s1:\nOnly HTTP is supported"਍∀䜀愀洀攀唀䤀开䐀漀眀渀氀漀愀搀䘀愀椀氀攀搀䌀愀渀琀䈀椀渀搀∀ऀ∀一漀 猀攀 栀愀 瀀漀搀椀搀漀 搀攀猀挀愀爀最愀爀 ─猀㄀㨀尀渀一漀 猀攀 瀀甀攀搀攀 愀猀漀挀椀愀爀 甀渀愀 戀愀猀攀∀ഀഀ
"[english]GameUI_DownloadFailedCantBind"	"Could not download %s1:\nCannot bind a socket"਍∀䜀愀洀攀唀䤀开䐀漀眀渀氀漀愀搀䘀愀椀氀攀搀䌀愀渀琀䌀漀渀渀攀挀琀∀ऀ∀一漀 猀攀 栀愀 瀀漀搀椀搀漀 搀攀猀挀愀爀最愀爀 ─猀㄀㨀尀渀一漀 栀愀 猀椀搀漀 瀀漀猀椀戀氀攀 挀漀渀攀挀琀愀爀 愀氀 猀攀爀瘀椀搀漀爀∀ഀഀ
"[english]GameUI_DownloadFailedCantConnect"	"Could not download %s1:\nCannot connect to server"਍∀䜀愀洀攀唀䤀开䐀漀眀渀氀漀愀搀䘀愀椀氀攀搀一漀䠀攀愀搀攀爀猀∀ऀ∀一漀 猀攀 栀愀 瀀漀搀椀搀漀 搀攀猀挀愀爀最愀爀 ─猀㄀㨀尀渀一漀 猀攀 栀愀 瀀漀搀椀搀漀 漀戀琀攀渀攀爀 椀渀昀漀爀洀愀挀椀渀 搀攀氀 猀攀爀瘀椀搀漀爀 猀漀戀爀攀 攀氀 愀爀挀栀椀瘀漀∀ഀഀ
"[english]GameUI_DownloadFailedNoHeaders"	"Could not download %s1:\nCannot get file info from server"਍∀䜀愀洀攀唀䤀开䐀漀眀渀氀漀愀搀䘀愀椀氀攀搀䘀椀氀攀一漀琀䘀漀甀渀搀∀ऀ∀一漀 猀攀 栀愀 瀀漀搀椀搀漀 搀攀猀挀愀爀最愀爀 ─猀㄀㨀尀渀䔀氀 愀爀挀栀椀瘀漀 渀漀 攀砀椀猀琀攀∀ഀഀ
"[english]GameUI_DownloadFailedFileNotFound"	"Could not download %s1:\nFile does not exist"਍∀䜀愀洀攀唀䤀开䌀甀爀爀攀渀琀倀氀愀礀攀爀猀∀ऀ∀匀䤀䰀䔀一䌀䤀䄀刀 䨀唀䜀䄀䐀伀刀䔀匀∀ഀഀ
"[english]GameUI_CurrentPlayers"	"MUTE PLAYERS"਍∀䜀愀洀攀唀䤀开䰀漀愀搀椀渀最䘀椀氀攀渀愀洀攀∀ऀ∀䌀愀爀最愀渀搀漀 ─猀㄀ ⸀⸀⸀∀ഀഀ
"[english]GameUI_LoadingFilename"	"Loading %s1 ..."਍∀䜀愀洀攀唀䤀开䔀瘀攀渀琀䰀椀猀琀∀ऀ∀䰀椀猀琀愀 搀攀 攀瘀攀渀琀漀猀∀ഀഀ
"[english]GameUI_EventList"	"Event List"਍∀䜀愀洀攀唀䤀开䔀搀椀琀䐀椀爀攀挀琀漀爀䌀漀洀洀愀渀搀∀ऀ∀䔀搀椀琀愀 挀漀洀愀渀搀漀 搀椀爀攀挀琀爀椀稀∀ഀഀ
"[english]GameUI_EditDirectorCommand"	"Edit director command"਍∀䜀愀洀攀唀䤀开䜀攀琀吀椀洀攀∀ऀ∀嘀攀爀 琀椀攀洀瀀漀∀ഀഀ
"[english]GameUI_GetTime"	"Get time"਍∀䜀愀洀攀唀䤀开䜀攀琀嘀椀攀眀∀ऀ∀嘀椀猀琀愀∀ഀഀ
"[english]GameUI_GetView"	"Get view"਍∀䜀愀洀攀唀䤀开䄀搀搀∀ऀ∀䄀愀搀椀爀∀ഀഀ
"[english]GameUI_Add"	"Add"਍∀䜀愀洀攀唀䤀开刀攀洀漀瘀攀∀ऀ∀䔀氀椀洀椀渀愀爀∀ഀഀ
"[english]GameUI_Remove"	"Remove"਍∀䜀愀洀攀唀䤀开䴀漀搀椀昀礀∀ऀ∀䴀漀搀椀昀椀挀愀爀∀ഀഀ
"[english]GameUI_Modify"	"Modify"਍∀䜀愀洀攀唀䤀开䜀漀琀漀∀ऀ∀嘀攀 愀∀ഀഀ
"[english]GameUI_Goto"	"Goto"਍∀䜀愀洀攀唀䤀开䔀瘀攀渀琀猀∀ऀ∀䔀瘀攀渀琀漀猀∀ഀഀ
"[english]GameUI_Events"	"Events"਍∀䜀愀洀攀唀䤀开匀愀瘀攀∀ऀ∀䜀甀愀爀搀愀爀∀ഀഀ
"[english]GameUI_Save"	"Save"਍∀䜀愀洀攀唀䤀开吀椀洀攀∀ऀ∀吀椀攀洀瀀漀∀ഀഀ
"[english]GameUI_Time"	"Time"਍∀䜀愀洀攀唀䤀开䌀倀唀倀氀愀礀攀爀伀瀀琀椀漀渀猀∀ऀ∀伀瀀挀椀漀渀攀猀 搀攀 樀甀最愀搀漀爀 䌀倀唀∀ഀഀ
"[english]GameUI_CPUPlayerOptions"	"CPU Player Options"਍∀䜀愀洀攀唀䤀开䴀攀搀椀甀洀䈀椀琀䐀攀瀀琀栀∀ऀ∀䴀攀搀椀漀 ⠀㄀㘀 戀椀琀⤀∀ഀഀ
"[english]GameUI_MediumBitDepth"	"Medium (16 bit)"਍∀䜀愀洀攀唀䤀开䠀椀最栀䈀椀琀䐀攀瀀琀栀∀ऀ∀匀甀瀀攀爀椀漀爀 ⠀㌀㈀ 戀椀琀⤀∀ഀഀ
"[english]GameUI_HighBitDepth"	"Highest (32 bit)"਍∀䜀愀洀攀唀䤀开倀爀攀挀愀挀栀椀渀最刀攀猀漀甀爀挀攀猀∀ऀ∀倀爀攀愀氀洀愀挀攀渀愀洀椀攀渀琀漀 攀渀 挀愀挀栀 搀攀 爀攀挀甀爀猀漀猀⸀⸀⸀∀ഀഀ
"[english]GameUI_PrecachingResources"	"Precaching resources..."਍∀䜀愀洀攀唀䤀开䰀漀愀搀椀渀最匀攀挀甀爀椀琀礀䴀漀搀甀氀攀∀ऀ∀䌀愀爀最愀渀搀漀 洀搀甀氀漀 搀攀 猀攀最甀爀椀搀愀搀⸀⸀⸀∀ഀഀ
"[english]GameUI_LoadingSecurityModule"	"Loading security module..."਍∀䜀愀洀攀唀䤀开匀攀挀甀爀椀琀礀䴀漀搀甀氀攀∀ऀ∀䴀搀甀氀漀 搀攀 猀攀最甀爀椀搀愀搀∀ഀഀ
"[english]GameUI_SecurityModule"	"Security module"਍∀䜀愀洀攀唀䤀开䐀漀眀渀氀漀愀搀椀渀最匀攀挀甀爀椀琀礀䴀漀搀甀氀攀∀ऀ∀䐀攀猀挀愀爀最愀渀搀漀 洀搀甀氀漀 搀攀 猀攀最甀爀椀搀愀搀∀ഀഀ
"[english]GameUI_DownloadingSecurityModule"	"Downloading security module"਍∀䜀愀洀攀唀䤀开䔀爀爀漀爀䰀漀愀搀椀渀最匀攀挀甀爀椀琀礀䴀漀搀甀氀攀∀ऀ∀䔀爀爀漀爀 愀氀 挀愀爀最愀爀 洀搀甀氀漀 搀攀 猀攀最甀爀椀搀愀搀⸀∀ഀഀ
"[english]GameUI_ErrorLoadingSecurityModule"	"Error loading security module."਍∀䜀愀洀攀唀䤀开䘀愀椀氀攀搀䐀漀眀渀氀漀愀搀匀攀挀甀爀椀琀礀䴀漀搀甀氀攀∀ऀ∀䔀爀爀漀爀 愀氀 搀攀猀挀愀爀最愀爀 洀搀甀氀漀 搀攀 猀攀最甀爀椀搀愀搀⸀∀ഀഀ
"[english]GameUI_FailedDownloadSecurityModule"	"Failed to download security module."਍∀䜀愀洀攀唀䤀开匀攀爀瘀攀爀䌀漀渀渀攀挀琀椀漀渀吀椀洀攀漀甀琀∀ऀ∀吀椀攀洀瀀漀 氀洀椀琀攀 搀攀 挀漀渀攀砀椀渀 愀氀 猀攀爀瘀椀搀漀爀⸀∀ഀഀ
"[english]GameUI_ServerConnectionTimeout"	"Connection to server timed out."਍∀䜀愀洀攀唀䤀开匀攀爀瘀攀爀䌀漀渀渀攀挀琀椀漀渀䘀愀椀氀攀搀䈀愀搀倀愀猀猀眀漀爀搀∀ऀ∀匀攀 栀愀 爀攀挀栀愀稀愀搀漀 氀愀 挀漀渀攀砀椀渀 愀氀 猀攀爀瘀椀搀漀爀 搀攀 樀甀攀最漀猀⸀尀渀䰀愀 挀漀渀琀爀愀猀攀愀 焀甀攀 栀愀猀 椀渀琀爀漀搀甀挀椀搀漀 渀漀 攀猀 瘀氀椀搀愀⸀∀ഀഀ
"[english]GameUI_ServerConnectionFailedBadPassword"	"Connection to game server refused.\nThe password you entered was incorrect."਍∀䜀愀洀攀唀䤀开匀愀瘀攀䜀愀洀攀开一攀眀匀愀瘀攀搀䜀愀洀攀∀ऀ∀一甀攀瘀愀 瀀愀爀琀椀搀愀 最甀愀爀搀愀搀愀∀ഀഀ
"[english]GameUI_SaveGame_NewSavedGame"	"New saved game"਍∀䜀愀洀攀唀䤀开匀愀瘀攀䜀愀洀攀开一攀眀匀愀瘀攀∀ऀ∀一甀攀瘀愀 瀀愀爀琀椀搀愀∀ഀഀ
"[english]GameUI_SaveGame_NewSave"	"New Save"਍∀䜀愀洀攀唀䤀开匀愀瘀攀䜀愀洀攀开一攀眀∀ऀ∀一甀攀瘀愀∀ഀഀ
"[english]GameUI_SaveGame_New"	"New"਍∀䜀愀洀攀唀䤀开匀愀瘀攀䜀愀洀攀开䌀甀爀爀攀渀琀∀ऀ∀䄀挀琀甀愀氀∀ഀഀ
"[english]GameUI_SaveGame_Current"	"Current"਍∀䜀愀洀攀唀䤀开匀愀瘀攀䜀愀洀攀开伀瘀攀爀眀爀椀琀攀∀ऀ∀匀漀戀爀攀猀挀爀椀戀椀爀 瀀愀爀琀椀搀愀∀ഀഀ
"[english]GameUI_SaveGame_Overwrite"	"Overwrite Save"਍∀䜀愀洀攀唀䤀开䠀攀愀搀瀀栀漀渀攀猀∀ऀ∀䄀甀爀椀挀甀氀愀爀攀猀∀ഀഀ
"[english]GameUI_Headphones"	"Headphones"਍∀䜀愀洀攀唀䤀开㈀匀瀀攀愀欀攀爀猀∀ऀ∀㈀ 愀氀琀愀瘀漀挀攀猀∀ഀഀ
"[english]GameUI_2Speakers"	"2 Speakers"਍∀䜀愀洀攀唀䤀开㐀匀瀀攀愀欀攀爀猀∀ऀ∀㐀 愀氀琀愀瘀漀挀攀猀∀ഀഀ
"[english]GameUI_4Speakers"	"4 Speakers"਍∀䜀愀洀攀唀䤀开㔀匀瀀攀愀欀攀爀猀∀ऀ∀䄀氀琀愀瘀漀挀攀猀 㔀⸀㄀∀ഀഀ
"[english]GameUI_5Speakers"	"5.1 Speakers"਍∀䜀愀洀攀唀䤀开㜀匀瀀攀愀欀攀爀猀∀ऀ∀䄀氀琀愀瘀漀挀攀猀 㜀⸀㄀∀ഀഀ
"[english]GameUI_7Speakers"	"7.1 Speakers"਍∀䜀愀洀攀唀䤀开匀瀀攀愀欀攀爀䌀漀渀昀椀最甀爀愀琀椀漀渀∀ऀ∀䌀漀渀昀椀最甀爀愀挀椀渀 搀攀 愀氀琀愀瘀漀挀攀猀∀ഀഀ
"[english]GameUI_SpeakerConfiguration"	"Speaker configuration"਍∀䜀愀洀攀唀䤀开一攀眀匀愀瘀攀䜀愀洀攀∀ऀ∀一唀䔀嘀䄀 倀䄀刀吀䤀䐀䄀 䜀唀䄀刀䐀䄀䐀䄀∀ഀഀ
"[english]GameUI_NewSaveGame"	"NEW SAVE GAME"਍∀䜀愀洀攀唀䤀开䌀漀渀昀椀爀洀䐀攀氀攀琀攀匀愀瘀攀䜀愀洀攀开吀椀琀氀攀∀ऀ∀뼀䈀伀刀刀䄀刀 倀䄀刀吀䤀䐀䄀 䜀唀䄀刀䐀䄀䐀䄀㼀∀ഀഀ
"[english]GameUI_ConfirmDeleteSaveGame_Title"	"DELETE SAVE GAME?"਍∀䜀愀洀攀唀䤀开䌀漀渀昀椀爀洀䐀攀氀攀琀攀匀愀瘀攀䜀愀洀攀开䤀渀昀漀∀ऀ∀뼀儀甀椀攀爀攀猀 戀漀爀爀愀爀 攀猀琀愀 瀀愀爀琀椀搀愀 最甀愀爀搀愀搀愀㼀尀渀匀攀 戀漀爀爀愀爀 瀀攀爀洀愀渀攀渀琀攀洀攀渀琀攀⸀∀ഀഀ
"[english]GameUI_ConfirmDeleteSaveGame_Info"	"Do you want to delete this save game?\nIt will be deleted permanently."਍∀䜀愀洀攀唀䤀开䌀漀渀昀椀爀洀䐀攀氀攀琀攀匀愀瘀攀䜀愀洀攀开伀䬀∀ऀ∀䔀氀椀洀椀渀愀爀∀ഀഀ
"[english]GameUI_ConfirmDeleteSaveGame_OK"	"Delete"਍∀䜀愀洀攀唀䤀开䌀漀渀昀椀爀洀伀瘀攀爀眀爀椀琀攀匀愀瘀攀䜀愀洀攀开吀椀琀氀攀∀ऀ∀䜀唀䄀刀䐀䄀刀∀ഀഀ
"[english]GameUI_ConfirmOverwriteSaveGame_Title"	"SAVE GAME"਍∀䜀愀洀攀唀䤀开䌀漀渀昀椀爀洀伀瘀攀爀眀爀椀琀攀匀愀瘀攀䜀愀洀攀开䤀渀昀漀∀ऀ∀뼀儀甀椀攀爀攀猀 猀漀戀爀攀猀挀爀椀戀椀爀 攀猀琀愀 瀀愀爀琀椀搀愀 最甀愀爀搀愀搀愀㼀∀ഀഀ
"[english]GameUI_ConfirmOverwriteSaveGame_Info"	"Do you want to overwrite this existing save game?"਍∀䜀愀洀攀唀䤀开䌀漀渀昀椀爀洀伀瘀攀爀眀爀椀琀攀匀愀瘀攀䜀愀洀攀开伀䬀∀ऀ∀匀漀戀爀攀猀挀爀椀戀椀爀∀ഀഀ
"[english]GameUI_ConfirmOverwriteSaveGame_OK"	"Overwrite"਍∀䜀愀洀攀唀䤀开匀愀瘀椀渀最圀愀爀渀椀渀最∀ऀ∀䜀甀愀爀搀愀渀搀漀 挀漀渀琀攀渀椀搀漀⸀尀渀一漀 愀瀀愀最甀攀猀 氀愀 挀漀渀猀漀氀愀⸀∀ഀഀ
"[english]GameUI_SavingWarning"	"Saving content.\nPlease don't turn off your console."਍∀䜀愀洀攀唀䤀开䜀愀洀攀匀愀瘀攀搀∀ऀ∀倀愀爀琀椀搀愀 最甀愀爀搀愀搀愀∀ഀഀ
"[english]GameUI_GameSaved"	"Game Saved"਍∀䜀愀洀攀唀䤀开䄀甀琀漀匀愀瘀攀开䌀漀渀猀漀氀攀开䔀砀瀀氀愀渀愀琀椀漀渀∀ऀ∀䔀猀琀攀 樀甀攀最漀 攀洀瀀氀攀愀 甀渀 猀椀猀琀攀洀愀 搀攀 最甀愀爀搀愀搀漀 愀甀琀漀洀琀椀挀漀 焀甀攀 最甀愀爀搀愀爀 氀愀 瀀愀爀琀椀搀愀 瀀攀爀椀搀椀挀愀洀攀渀琀攀 猀椀渀 瀀爀攀瘀椀漀 愀瘀椀猀漀⸀ 一漀 愀瀀愀最甀攀猀 氀愀 挀漀渀猀漀氀愀 堀戀漀砀 ㌀㘀　 洀椀攀渀琀爀愀猀 猀攀 最甀愀爀搀愀 愀甀琀漀洀琀椀挀愀洀攀渀琀攀 氀愀 瀀愀爀琀椀搀愀⸀∀ഀഀ
"[english]GameUI_AutoSave_Console_Explanation"	"This game uses an autosave system that will periodically save your progress without warning. Please do not turn off your Xbox console during an autosave."਍∀䜀愀洀攀唀䤀开䌀漀渀昀椀爀洀䰀漀愀搀䜀愀洀攀开吀椀琀氀攀∀ऀ∀䌀䄀刀䜀䄀刀 倀䄀刀吀䤀䐀䄀∀ഀഀ
"[english]GameUI_ConfirmLoadGame_Title"	"LOAD GAME"਍∀䜀愀洀攀唀䤀开䰀漀愀搀圀愀爀渀椀渀最∀ऀ∀뼀匀攀最甀爀漀 焀甀攀 搀攀猀攀愀猀 挀愀爀最愀爀㼀尀渀䰀漀猀 愀瘀愀渀挀攀猀 焀甀攀 渀漀 栀愀礀愀猀 最甀愀爀搀愀搀漀 猀攀 瀀攀爀搀攀爀渀⸀∀ഀഀ
"[english]GameUI_LoadWarning"	"Are you sure you want to load?\nAll unsaved progress will be lost."਍∀䜀愀洀攀唀䤀开䌀漀渀昀椀爀洀一攀眀䜀愀洀攀开吀椀琀氀攀∀ऀ∀一唀䔀嘀䄀 倀䄀刀吀䤀䐀䄀∀ഀഀ
"[english]GameUI_ConfirmNewGame_Title"	"NEW GAME"਍∀䜀愀洀攀唀䤀开一攀眀䜀愀洀攀圀愀爀渀椀渀最∀ऀ∀뼀匀攀最甀爀漀 焀甀攀 焀甀椀攀爀攀猀 椀渀椀挀椀愀爀 甀渀愀 渀甀攀瘀愀 瀀愀爀琀椀搀愀㼀尀渀䰀漀猀 愀瘀愀渀挀攀猀 焀甀攀 渀漀 栀愀礀愀猀 最甀愀爀搀愀搀漀 猀攀 瀀攀爀搀攀爀渀⸀∀ഀഀ
"[english]GameUI_NewGameWarning"	"Are you sure you want to start a new game?\nAll unsaved progress will be lost."਍∀䜀愀洀攀唀䤀开刀愀渀搀漀洀䴀愀瀀∀ऀ∀㰀 䴀愀瀀愀 愀氀攀愀琀漀爀椀漀 㸀∀ഀഀ
"[english]GameUI_RandomMap"	"< Random Map >"਍∀䜀愀洀攀唀䤀开刀攀琀爀礀椀渀最䌀漀渀渀攀挀琀椀漀渀吀漀匀攀爀瘀攀爀∀ऀ∀刀攀椀渀琀攀渀琀愀渀搀漀 挀漀渀攀挀琀愀爀 挀漀渀 攀氀 猀攀爀瘀椀搀漀爀⸀⸀⸀∀ഀഀ
"[english]GameUI_RetryingConnectionToServer"	"Retrying connection to server..."਍∀䜀愀洀攀唀䤀开刀攀琀爀礀椀渀最䌀漀渀渀攀挀琀椀漀渀吀漀匀攀爀瘀攀爀㈀∀ऀ∀刀攀椀渀琀攀渀琀愀渀搀漀 挀漀渀攀挀琀愀爀 挀漀渀 攀氀 猀攀爀瘀椀搀漀爀 ⠀㈀⤀⸀⸀⸀∀ഀഀ
"[english]GameUI_RetryingConnectionToServer2"	"Retrying connection to server (2)..."਍∀䜀愀洀攀唀䤀开刀攀琀爀礀椀渀最䌀漀渀渀攀挀琀椀漀渀吀漀匀攀爀瘀攀爀㌀∀ऀ∀刀攀椀渀琀攀渀琀愀渀搀漀 挀漀渀攀挀琀愀爀 挀漀渀 攀氀 猀攀爀瘀椀搀漀爀 ⠀㌀⤀⸀⸀⸀∀ഀഀ
"[english]GameUI_RetryingConnectionToServer3"	"Retrying connection to server (3)..."਍∀䜀愀洀攀唀䤀开䌀漀甀氀搀一漀琀䌀漀渀琀愀挀琀䜀愀洀攀匀攀爀瘀攀爀∀ऀ∀一漀 猀攀 栀愀 瀀漀搀椀搀漀 挀漀渀琀愀挀琀愀爀 挀漀渀 攀氀 猀攀爀瘀椀搀漀爀 搀攀 樀甀攀最漀猀∀ഀഀ
"[english]GameUI_CouldNotContactGameServer"	"Failed to contact game server"਍∀䜀愀洀攀唀䤀开刀攀昀爀攀猀栀䰀漀最椀渀开䤀渀昀漀吀椀挀欀攀琀䔀砀瀀椀爀攀搀∀ऀ∀吀甀 琀椀挀欀攀琀 匀琀攀愀洀 栀愀 挀愀搀甀挀愀搀漀⸀尀渀嘀甀攀氀瘀攀 愀 椀渀琀爀漀搀甀挀椀爀 琀甀 挀漀渀琀爀愀猀攀愀 瀀愀爀愀 挀漀渀琀椀渀甀愀爀⸀∀ഀഀ
"[english]GameUI_RefreshLogin_InfoTicketExpired"	"Your steam ticket has expired.\nPlease re-enter your password to continue."਍∀䜀愀洀攀唀䤀开刀攀昀爀攀猀栀䰀漀最椀渀开唀猀攀爀一愀洀攀∀ऀ∀一漀洀戀爀攀 搀攀 挀甀攀渀琀愀∀ഀഀ
"[english]GameUI_RefreshLogin_UserName"	"Account name"਍∀䜀愀洀攀唀䤀开刀攀昀爀攀猀栀䰀漀最椀渀开倀愀猀猀眀漀爀搀∀ऀ∀䌀漀渀琀爀愀猀攀愀∀ഀഀ
"[english]GameUI_RefreshLogin_Password"	"Password"਍∀䜀愀洀攀唀䤀开刀攀昀爀攀猀栀䰀漀最椀渀开䰀漀最椀渀∀ऀ∀䌀漀渀攀挀琀愀爀猀攀∀ഀഀ
"[english]GameUI_RefreshLogin_Login"	"Login"਍∀䜀愀洀攀唀䤀开刀攀昀爀攀猀栀䰀漀最椀渀开䌀愀渀挀攀氀∀ऀ∀䌀愀渀挀攀氀愀爀∀ഀഀ
"[english]GameUI_RefreshLogin_Cancel"	"Cancel"਍∀䜀愀洀攀唀䤀开刀攀昀爀攀猀栀䰀漀最椀渀∀ऀ∀嘀漀氀瘀攀爀 愀 椀渀椀挀椀愀爀 猀攀猀椀渀∀ഀഀ
"[english]GameUI_RefreshLogin"	"Refresh Login"਍∀䜀愀洀攀唀䤀开刀攀昀爀攀猀栀䰀漀最椀渀开刀攀洀攀洀戀攀爀倀愀猀猀眀漀爀搀∀ऀ∀刀攀挀漀爀搀愀爀 洀椀 挀漀渀琀爀愀猀攀愀∀ഀഀ
"[english]GameUI_RefreshLogin_RememberPassword"	"Remember my password"਍∀䜀愀洀攀唀䤀开䰀漀最椀渀开䔀爀爀漀爀吀椀琀氀攀∀ऀ∀嘀漀氀瘀攀爀 愀 椀渀椀挀椀愀爀 猀攀猀椀渀 ⴀ 䔀爀爀漀爀∀ഀഀ
"[english]GameUI_Login_ErrorTitle"	"Refresh Login - Error"਍∀䜀愀洀攀唀䤀开䔀爀爀漀爀䰀漀最椀渀䘀愀椀氀攀搀∀ऀ∀一漀 猀攀 栀愀 瀀漀搀椀搀漀 椀渀椀挀椀愀爀 猀攀猀椀渀⸀ 䤀渀琀渀琀愀氀漀 搀攀 渀甀攀瘀漀⸀∀ഀഀ
"[english]GameUI_ErrorLoginFailed"	"Login Failed. Please try again."਍∀䰀漀愀搀椀渀最倀爀漀最爀攀猀猀开匀瀀愀眀渀椀渀最匀攀爀瘀攀爀∀ऀ∀䤀渀椀挀椀愀渀搀漀 猀攀爀瘀椀搀漀爀 搀攀 瀀愀爀琀椀搀愀 氀漀挀愀氀⸀⸀⸀∀ഀഀ
"[english]LoadingProgress_SpawningServer"	"Starting local game server..."਍∀䰀漀愀搀椀渀最倀爀漀最爀攀猀猀开䰀漀愀搀䴀愀瀀∀ऀ∀䌀愀爀最愀渀搀漀 洀甀渀搀漀⸀⸀⸀∀ഀഀ
"[english]LoadingProgress_LoadMap"	"Loading world..."਍∀䰀漀愀搀椀渀最倀爀漀最爀攀猀猀开倀爀攀挀愀挀栀攀圀漀爀氀搀∀ऀ∀䤀渀椀挀椀愀渀搀漀 洀甀渀搀漀⸀⸀⸀∀ഀഀ
"[english]LoadingProgress_PrecacheWorld"	"Initializing world..."਍∀䰀漀愀搀椀渀最倀爀漀最爀攀猀猀开䰀漀愀搀刀攀猀漀甀爀挀攀猀∀ऀ∀䌀愀爀最愀渀搀漀 爀攀挀甀爀猀漀猀⸀⸀⸀∀ഀഀ
"[english]LoadingProgress_LoadResources"	"Loading resources..."਍∀䰀漀愀搀椀渀最倀爀漀最爀攀猀猀开匀椀最渀漀渀䰀漀挀愀氀∀ऀ∀䤀渀椀挀椀愀渀搀漀 爀攀挀甀爀猀漀猀⸀⸀⸀∀ഀഀ
"[english]LoadingProgress_SignonLocal"	"Initializing resources..."਍∀䰀漀愀搀椀渀最倀爀漀最爀攀猀猀开匀椀最渀漀渀䐀愀琀愀䰀漀挀愀氀∀ऀ∀䤀渀椀挀椀愀渀搀漀 搀愀琀漀猀 搀攀氀 樀甀攀最漀⸀⸀⸀∀ഀഀ
"[english]LoadingProgress_SignonDataLocal"	"Initializing game data..."਍∀䰀漀愀搀椀渀最倀爀漀最爀攀猀猀开䈀攀最椀渀䌀漀渀渀攀挀琀∀ऀ∀䔀猀琀愀戀氀攀挀椀攀渀搀漀 挀漀渀攀砀椀渀 挀漀渀 攀氀 猀攀爀瘀椀搀漀爀⸀⸀⸀∀ഀഀ
"[english]LoadingProgress_BeginConnect"	"Establishing connection to server..."਍∀䰀漀愀搀椀渀最倀爀漀最爀攀猀猀开䌀漀渀渀攀挀琀椀渀最∀ऀ∀䌀漀渀攀挀琀愀渀搀漀 挀漀渀 攀氀 猀攀爀瘀椀搀漀爀⸀⸀⸀∀ഀഀ
"[english]LoadingProgress_Connecting"	"Connecting to server..."਍∀䰀漀愀搀椀渀最倀爀漀最爀攀猀猀开倀爀漀挀攀猀猀匀攀爀瘀攀爀䤀渀昀漀∀ऀ∀伀戀琀攀渀椀攀渀搀漀 椀渀昀漀爀洀愀挀椀渀 搀攀氀 猀攀爀瘀椀搀漀爀⸀⸀⸀∀ഀഀ
"[english]LoadingProgress_ProcessServerInfo"	"Retrieving server info..."਍∀䰀漀愀搀椀渀最倀爀漀最爀攀猀猀开匀攀渀搀䌀氀椀攀渀琀䤀渀昀漀∀ऀ∀䔀渀瘀椀愀渀搀漀 椀渀昀漀爀洀愀挀椀渀 搀攀氀 挀氀椀攀渀琀攀⸀⸀⸀∀ഀഀ
"[english]LoadingProgress_SendClientInfo"	"Sending client info..."਍∀䰀漀愀搀椀渀最倀爀漀最爀攀猀猀开匀椀最渀漀渀䐀愀琀愀∀ऀ∀伀戀琀攀渀椀攀渀搀漀 搀愀琀漀猀 搀攀氀 樀甀攀最漀⸀⸀⸀∀ഀഀ
"[english]LoadingProgress_SignonData"	"Retrieving game data..."਍∀䰀漀愀搀椀渀最倀爀漀最爀攀猀猀开䌀栀愀渀最攀氀攀瘀攀氀∀ऀ∀䔀氀 猀攀爀瘀椀搀漀爀 攀猀琀 挀愀洀戀椀愀渀搀漀 攀氀 渀椀瘀攀氀⸀⸀⸀∀ഀഀ
"[english]LoadingProgress_Changelevel"	"Server is changing level..."਍∀䜀愀洀攀唀䤀开䐀椀昀昀椀挀甀氀琀礀∀ऀ∀䐀椀昀椀挀甀氀琀愀搀∀ഀഀ
"[english]GameUI_Difficulty"	"Difficulty"਍∀䜀愀洀攀唀䤀开匀欀椀氀氀䔀愀猀礀∀ऀ∀䘀挀椀氀∀ഀഀ
"[english]GameUI_SkillEasy"	"Easy"਍∀䜀愀洀攀唀䤀开匀欀椀氀氀一漀爀洀愀氀∀ऀ∀一漀爀洀愀氀∀ഀഀ
"[english]GameUI_SkillNormal"	"Normal"਍∀䜀愀洀攀唀䤀开匀欀椀氀氀䠀愀爀搀∀ऀ∀䐀椀昀挀椀氀∀ഀഀ
"[english]GameUI_SkillHard"	"Hard"਍∀䜀愀洀攀唀䤀开匀攀氀攀挀琀䐀椀昀昀椀挀甀氀琀礀∀ऀ∀䐀椀昀椀挀甀氀琀愀搀 搀攀氀 挀漀洀戀愀琀攀㨀∀ഀഀ
"[english]GameUI_SelectDifficulty"	"Combat difficulty:"਍∀䜀愀洀攀唀䤀开倀漀爀琀愀氀∀ऀ∀倀漀爀琀愀氀攀猀∀ഀഀ
"[english]GameUI_Portal"	"Portals"਍∀䜀愀洀攀唀䤀开倀漀爀琀愀氀䐀攀瀀琀栀䰀愀戀攀氀∀ऀ∀倀爀漀昀甀渀搀椀搀愀搀 搀攀 爀攀渀搀攀爀椀稀愀搀漀∀ഀഀ
"[english]GameUI_PortalDepthLabel"	"Portal render depth"਍∀䜀愀洀攀唀䤀开倀漀爀琀愀氀䐀攀瀀琀栀　∀ऀ∀　∀ഀഀ
"[english]GameUI_PortalDepth0"	"0"਍∀䜀愀洀攀唀䤀开倀漀爀琀愀氀䐀攀瀀琀栀㄀∀ऀ∀㄀∀ഀഀ
"[english]GameUI_PortalDepth1"	"1"਍∀䜀愀洀攀唀䤀开倀漀爀琀愀氀䐀攀瀀琀栀㈀∀ऀ∀㈀ ⠀爀攀挀漀洀攀渀搀愀搀漀⤀∀ഀഀ
"[english]GameUI_PortalDepth2"	"2 (recommended)"਍∀䜀愀洀攀唀䤀开倀漀爀琀愀氀䐀攀瀀琀栀㌀∀ऀ∀㌀∀ഀഀ
"[english]GameUI_PortalDepth3"	"3"਍∀䜀愀洀攀唀䤀开倀漀爀琀愀氀䐀攀瀀琀栀㔀∀ऀ∀㔀∀ഀഀ
"[english]GameUI_PortalDepth5"	"5"਍∀䜀愀洀攀唀䤀开倀漀爀琀愀氀䐀攀瀀琀栀㘀∀ऀ∀㘀∀ഀഀ
"[english]GameUI_PortalDepth6"	"6"਍∀䜀愀洀攀唀䤀开倀漀爀琀愀氀䐀攀瀀琀栀㜀∀ऀ∀㜀∀ഀഀ
"[english]GameUI_PortalDepth7"	"7"਍∀䜀愀洀攀唀䤀开倀漀爀琀愀氀䐀攀瀀琀栀㠀∀ऀ∀㠀∀ഀഀ
"[english]GameUI_PortalDepth8"	"8"਍∀䜀愀洀攀唀䤀开倀漀爀琀愀氀䐀攀瀀琀栀㤀∀ऀ∀㤀∀ഀഀ
"[english]GameUI_PortalDepth9"	"9"਍∀䜀愀洀攀唀䤀开倀漀爀琀愀氀䘀甀渀渀攀氀∀ऀ∀䔀渀挀愀甀稀愀爀 瀀漀爀琀愀氀∀ഀഀ
"[english]GameUI_PortalFunnel"	"Portal funnel"਍∀䜀愀洀攀唀䤀开倀漀爀琀愀氀䘀甀渀渀攀氀䰀愀戀攀氀∀ऀ∀吀攀 愀礀甀搀愀 愀 愀瀀甀渀琀愀爀 愀 氀漀猀 瀀漀爀琀愀氀攀猀 搀攀氀 猀甀攀氀漀∀ഀഀ
"[english]GameUI_PortalFunnelLabel"	"The computer helps you aim into floor portals"਍∀䜀愀洀攀唀䤀开䌀爀漀猀猀栀愀椀爀䐀攀猀挀爀椀瀀琀椀漀渀∀ऀ∀䄀猀瀀攀挀琀漀 搀攀 洀椀爀愀∀ഀഀ
"[english]GameUI_CrosshairDescription"	"Crosshair appearance"਍∀䜀愀洀攀唀䤀开䄀甀琀漀∀ऀ∀吀愀洀愀漀 愀甀琀漀洀琀椀挀漀∀ഀഀ
"[english]GameUI_Auto"	"Auto-size"਍∀䜀愀洀攀唀䤀开匀洀愀氀氀∀ऀ∀倀攀焀甀攀愀∀ഀഀ
"[english]GameUI_Small"	"Small"਍∀䜀愀洀攀唀䤀开䰀愀爀最攀∀ऀ∀䜀爀愀渀搀攀∀ഀഀ
"[english]GameUI_Large"	"Large"਍∀䜀愀洀攀唀䤀开吀爀愀渀猀氀甀挀攀渀琀∀ऀ∀吀爀愀渀猀氀切挀椀搀愀∀ഀഀ
"[english]GameUI_Translucent"	"Translucent"਍∀䜀愀洀攀唀䤀开䌀爀漀猀猀栀愀椀爀刀攀搀∀ऀ∀刀漀樀愀∀ഀഀ
"[english]GameUI_CrosshairRed"	"Red"਍∀䜀愀洀攀唀䤀开䌀爀漀猀猀栀愀椀爀䜀爀攀攀渀∀ऀ∀嘀攀爀搀攀∀ഀഀ
"[english]GameUI_CrosshairGreen"	"Green"਍∀䜀愀洀攀唀䤀开䌀爀漀猀猀栀愀椀爀䈀氀甀攀∀ऀ∀䄀稀甀氀∀ഀഀ
"[english]GameUI_CrosshairBlue"	"Blue"਍∀䜀愀洀攀唀䤀开䌀爀漀猀猀栀愀椀爀匀挀愀氀攀∀ऀ∀吀愀洀愀漀∀ഀഀ
"[english]GameUI_CrosshairScale"	"Size"਍∀䜀愀洀攀唀䤀开䘀愀猀琀匀眀椀琀挀栀䌀栀攀挀欀∀ऀ∀䌀愀洀戀椀漀 爀瀀椀搀漀 搀攀 愀爀洀愀猀∀ഀഀ
"[english]GameUI_FastSwitchCheck"	"Fast weapon switch"਍∀䜀愀洀攀唀䤀开䐀攀瘀攀氀漀瀀攀爀䌀漀渀猀漀氀攀䌀栀攀挀欀∀ऀ∀䄀挀琀椀瘀愀爀 挀漀渀猀漀氀愀 搀攀氀 瀀爀漀最爀愀洀愀搀漀爀∀ഀഀ
"[english]GameUI_DeveloperConsoleCheck"	"Enable developer console"਍∀䜀愀洀攀唀䤀开䬀攀礀戀漀愀爀搀䄀搀瘀愀渀挀攀搀开吀椀琀氀攀∀ऀ∀吀䔀䌀䰀䄀䐀伀 ⴀ 䄀嘀䄀一娀䄀䐀伀∀ഀഀ
"[english]GameUI_KeyboardAdvanced_Title"	"KEYBOARD - ADVANCED"਍∀䜀愀洀攀唀䤀开伀瀀琀椀漀渀猀刀攀猀琀愀爀琀刀攀焀甀椀爀攀搀开吀椀琀氀攀∀ऀ∀伀倀䌀䤀伀一䔀匀 ⴀ 刀䔀䤀一䤀䌀䤀䄀刀∀ഀഀ
"[english]GameUI_OptionsRestartRequired_Title"	"OPTIONS - RESTART"਍∀䜀愀洀攀唀䤀开伀瀀琀椀漀渀猀刀攀猀琀愀爀琀刀攀焀甀椀爀攀搀开䤀渀昀漀∀ऀ∀倀愀爀愀 瀀漀搀攀爀 愀瀀氀椀挀愀爀 攀猀琀漀猀 挀愀洀戀椀漀猀Ⰰ 琀攀渀搀爀猀 焀甀攀 爀攀椀渀椀挀椀愀爀 攀氀 樀甀攀最漀⸀尀渀뼀儀甀椀攀爀攀猀 爀攀椀渀椀挀椀愀爀氀漀 愀栀漀爀愀㼀∀ഀഀ
"[english]GameUI_OptionsRestartRequired_Info"	"The changes you have made require the game to be\nrestarted.  Do you wish to restart now?"਍∀䜀愀洀攀唀䤀开伀瀀琀椀漀渀猀刀攀猀琀愀爀琀开伀䬀䈀甀琀琀漀渀∀ऀ∀刀攀椀渀椀挀椀愀爀 愀栀漀爀愀∀ഀഀ
"[english]GameUI_OptionsRestart_OKButton"	"Restart now"਍∀䜀愀洀攀唀䤀开伀瀀琀椀漀渀猀刀攀猀琀愀爀琀开䌀愀渀挀攀氀䈀甀琀琀漀渀∀ऀ∀刀攀椀渀椀挀椀愀爀 洀猀 琀愀爀搀攀∀ഀഀ
"[english]GameUI_OptionsRestart_CancelButton"	"Restart later"਍∀䜀愀洀攀唀䤀开嘀椀搀攀漀䄀搀瘀愀渀挀攀搀开吀椀琀氀攀∀ऀ∀嘀촀䐀䔀伀 ⴀ 䄀嘀䄀一娀䄀䐀伀∀ഀഀ
"[english]GameUI_VideoAdvanced_Title"	"VIDEO - ADVANCED"਍∀䜀愀洀攀唀䤀开䠀甀搀儀甀椀挀欀䤀渀昀漀∀ऀ∀䤀渀昀漀爀洀愀挀椀渀 爀瀀椀搀愀∀ഀഀ
"[english]GameUI_HudQuickInfo"	"Quick info"਍∀䜀愀洀攀唀䤀开䠀甀搀儀甀椀挀欀䤀渀昀漀开䤀渀昀漀∀ऀ∀䴀漀猀琀爀愀爀 猀愀氀甀搀 礀 洀甀渀椀挀椀漀渀攀猀 攀渀 氀愀 洀椀爀愀∀ഀഀ
"[english]GameUI_HudQuickInfo_Info"	"Show health and ammo info on crosshair"਍∀䜀愀洀攀唀䤀开一漀䈀漀渀甀猀䴀愀瀀猀吀漀䐀椀猀瀀氀愀礀∀ऀ∀一漀 栀愀礀 洀愀瀀愀猀 搀攀 戀漀渀椀昀椀挀愀挀椀渀 攀渀 攀猀琀攀 搀椀爀攀挀琀漀爀椀漀⸀∀ഀഀ
"[english]GameUI_NoBonusMapsToDisplay"	"There are no bonus maps in this directory."਍∀䜀愀洀攀唀䤀开一漀匀愀瘀攀䜀愀洀攀猀吀漀䐀椀猀瀀氀愀礀∀ऀ∀一漀 栀愀礀 瀀愀爀琀椀搀愀猀 最甀愀爀搀愀搀愀猀 瀀愀爀愀 洀漀猀琀爀愀爀⸀∀ഀഀ
"[english]GameUI_NoSaveGamesToDisplay"	"There are currently no save games to display."਍∀䜀愀洀攀唀䤀开匀愀瘀攀䜀愀洀攀开䌀漀爀爀甀瀀琀䘀椀氀攀∀ऀ∀䔀猀琀愀猀 瀀愀爀琀椀搀愀猀 最甀愀爀搀愀搀愀猀 攀猀琀渀 搀愀愀搀愀猀尀渀礀 渀漀 瀀甀攀搀攀渀 挀愀爀最愀爀猀攀⸀∀ഀഀ
"[english]GameUI_SaveGame_CorruptFile"	"These saved game files have been damaged or corrupted,\nand cannot be loaded."਍∀䜀愀洀攀唀䤀开䔀愀猀礀䐀攀猀挀爀椀瀀琀椀漀渀∀ऀ∀䰀漀猀 攀渀攀洀椀最漀猀 猀漀渀 昀挀椀氀攀猀 搀攀 搀攀爀爀漀琀愀爀⸀ 䔀氀 漀爀搀攀渀愀搀漀爀 愀礀甀搀愀 愀 愀瀀甀渀琀愀爀⸀∀ഀഀ
"[english]GameUI_EasyDescription"	"Enemies are easy to defeat, and the computer helps you aim."਍∀䜀愀洀攀唀䤀开一漀爀洀愀氀䐀攀猀挀爀椀瀀琀椀漀渀∀ऀ∀䔀渀攀洀椀最漀猀 挀漀洀瀀氀椀挀愀搀漀猀㬀 氀愀猀 愀爀洀愀猀 挀愀甀猀愀渀 搀愀漀 渀漀爀洀愀氀⸀∀ഀഀ
"[english]GameUI_NormalDescription"	"Challenging enemies; your weapons do normal damage."਍∀䜀愀洀攀唀䤀开䠀愀爀搀䐀攀猀挀爀椀瀀琀椀漀渀∀ऀ∀䰀漀猀 攀渀攀洀椀最漀猀 猀漀渀 洀猀 搀椀昀挀椀氀攀猀 搀攀 戀愀琀椀爀⸀ 吀甀猀 愀爀洀愀猀 猀漀渀 洀攀渀漀猀 攀昀椀挀愀挀攀猀⸀∀ഀഀ
"[english]GameUI_HardDescription"	"Enemies are very tough; your weapons are less effective."਍∀䜀愀洀攀唀䤀开䌀氀漀猀攀䌀愀瀀琀椀漀渀猀开䌀栀攀挀欀戀漀砀∀ऀ∀䴀漀猀琀爀愀爀 猀甀戀琀琀甀氀漀猀∀ഀഀ
"[english]GameUI_CloseCaptions_Checkbox"	"Display captions"਍∀䜀愀洀攀唀䤀开吀攀猀琀匀瀀攀愀欀攀爀匀攀琀琀椀渀最猀∀ऀ∀倀爀漀戀愀爀 挀漀渀昀椀最甀爀愀挀椀渀 搀攀 氀漀猀 愀氀琀愀瘀漀挀攀猀∀ഀഀ
"[english]GameUI_TestSpeakerSettings"	"Test speaker settings"਍∀䜀愀洀攀唀䤀开吀攀猀琀匀瀀攀愀欀攀爀匀攀琀琀椀渀最猀圀愀爀渀椀渀最∀ऀ∀䄀氀 瀀爀漀戀愀爀 氀愀 挀漀渀昀椀最甀爀愀挀椀渀 搀攀 氀漀猀 愀氀琀愀瘀漀挀攀猀 猀攀 琀攀 搀攀猀挀漀渀攀挀琀愀爀 搀攀氀 樀甀攀最漀 攀渀 挀甀爀猀漀∀ഀഀ
"[english]GameUI_TestSpeakerSettingsWarning"	"Testing speaker settings will disconnect you from the current game"਍∀䜀愀洀攀唀䤀开䔀渀愀戀氀攀搀∀ऀ∀䄀挀琀椀瘀愀搀漀∀ഀഀ
"[english]GameUI_Enabled"	"Enabled"਍∀䜀愀洀攀唀䤀开䐀椀猀愀戀氀攀搀∀ऀ∀䐀攀猀愀挀琀椀瘀愀搀漀∀ഀഀ
"[english]GameUI_Disabled"	"Disabled"਍∀最愀洀攀甀椀开渀漀爀攀昀氀攀挀琀椀漀渀猀∀ऀ∀刀攀昀氀攀樀漀猀 猀攀渀挀椀氀氀漀猀∀ഀഀ
"[english]gameui_noreflections"	"Simple reflections"਍∀最愀洀攀甀椀开爀攀昀氀攀挀琀漀渀氀礀眀漀爀氀搀∀ऀ∀刀攀昀氀攀樀愀爀 洀甀渀搀漀∀ഀഀ
"[english]gameui_reflectonlyworld"	"Reflect world"਍∀最愀洀攀甀椀开爀攀昀氀攀挀琀愀氀氀∀ऀ∀刀攀昀氀攀樀愀爀 琀漀搀漀猀∀ഀഀ
"[english]gameui_reflectall"	"Reflect all"਍∀䜀愀洀攀唀䤀开刀攀瀀漀爀琀䈀甀最∀ऀ∀一伀吀䤀䘀䤀䌀䄀刀 䔀刀刀伀刀∀ഀഀ
"[english]GameUI_ReportBug"	"REPORT BUG"਍∀䜀愀洀攀唀䤀开䈀甀最开匀甀挀挀攀猀猀昀甀氀∀ऀ∀ꄀ䔀爀爀漀爀 渀漀琀椀昀椀挀愀搀漀 挀漀爀爀攀挀琀愀洀攀渀琀攀℀∀ഀഀ
"[english]GameUI_Bug_Successful"	"Bug successfully submitted!"਍∀䜀愀洀攀唀䤀开䈀甀最开匀甀戀洀椀琀琀椀渀最∀ऀ∀䔀渀瘀椀愀渀搀漀 攀爀爀漀爀⸀⸀⸀∀ഀഀ
"[english]GameUI_Bug_Submitting"	"Submitting Bug..."਍∀䜀愀洀攀唀䤀开䈀甀最开吀愀欀攀匀挀爀攀攀渀猀栀漀琀∀ऀ∀䌀愀瀀琀甀爀愀 搀攀 瀀愀渀琀愀氀氀愀∀ഀഀ
"[english]GameUI_Bug_TakeScreenshot"	"Take screenshot"਍∀䜀愀洀攀唀䤀开䈀甀最开䄀琀琀愀挀栀匀愀瘀攀搀䜀愀洀攀∀ऀ∀䄀搀樀⸀ 瀀愀爀琀椀搀愀 最甀愀爀搀愀搀愀∀ഀഀ
"[english]GameUI_Bug_AttachSavedGame"	"Attach saved game"਍∀䜀愀洀攀唀䤀开䈀甀最开䌀氀攀愀爀䘀漀爀洀∀ऀ∀䈀漀爀爀愀爀 昀漀爀洀甀氀愀爀椀漀∀ഀഀ
"[english]GameUI_Bug_ClearForm"	"Clear Form"਍∀䜀愀洀攀唀䤀开䈀甀最开吀椀琀氀攀∀ऀ∀吀琀甀氀漀㨀∀ഀഀ
"[english]GameUI_Bug_Title"	"Title:"਍∀䜀愀洀攀唀䤀开䈀甀最开䐀攀猀挀爀椀瀀琀椀漀渀∀ऀ∀䐀攀猀挀爀椀瀀挀椀渀㨀∀ഀഀ
"[english]GameUI_Bug_Description"	"Description:"਍∀䜀愀洀攀唀䤀开䈀甀最开倀漀猀椀琀椀漀渀∀ऀ∀倀漀猀椀挀椀渀㨀∀ഀഀ
"[english]GameUI_Bug_Position"	"Position:"਍∀䜀愀洀攀唀䤀开䈀甀最开䴀愀瀀∀ऀ∀䴀愀瀀愀㨀∀ഀഀ
"[english]GameUI_Bug_Map"	"Map:"਍∀䜀愀洀攀唀䤀开䈀甀最开伀爀椀攀渀琀愀琀椀漀渀∀ऀ∀伀爀椀攀渀琀愀挀椀渀㨀∀ഀഀ
"[english]GameUI_Bug_Orientation"	"Orientation:"਍∀䜀愀洀攀唀䤀开䈀甀最开刀攀瀀漀爀琀吀礀瀀攀∀ऀ∀吀椀瀀漀 搀攀 椀渀昀漀爀洀攀㨀∀ഀഀ
"[english]GameUI_Bug_ReportType"	"Report type:"਍∀䜀愀洀攀唀䤀开䈀甀最开䔀洀愀椀氀䄀搀搀爀攀猀猀∀ऀ∀䔀洀愀椀氀㨀∀ഀഀ
"[english]GameUI_Bug_EmailAddress"	"Email Address:"਍∀䜀愀洀攀唀䤀开䈀甀最开倀爀椀瘀愀挀礀倀漀氀椀挀礀∀ऀ∀倀漀氀琀椀挀愀 搀攀 倀爀椀瘀愀挀椀搀愀搀∀ഀഀ
"[english]GameUI_Bug_PrivacyPolicy"	"Valve's Privacy Policy"਍∀䜀愀洀攀唀䤀开䈀甀最开伀瀀琀椀漀渀愀氀∀ऀ∀⠀漀瀀挀椀漀渀愀氀⤀∀ഀഀ
"[english]GameUI_Bug_Optional"	"(optional)"਍∀䜀愀洀攀唀䤀开䈀甀最开䄀挀挀漀甀渀琀一愀洀攀∀ऀ∀䌀甀攀渀琀愀㨀∀ഀഀ
"[english]GameUI_Bug_AccountName"	"Account Name:"਍∀䜀愀洀攀唀䤀开䈀甀最开䔀渀最椀渀攀䈀甀椀氀搀∀ऀ∀嘀䔀刀匀䤀팀一 匀伀唀刀䌀䔀㨀∀ഀഀ
"[english]GameUI_Bug_EngineBuild"	"SOURCE ENGINE BUILD:"਍∀䜀愀洀攀唀䤀开䈀甀最开匀甀戀洀椀琀∀ऀ∀䔀渀瘀椀愀爀∀ഀഀ
"[english]GameUI_Bug_Submit"	"Submit"਍∀䜀愀洀攀唀䤀开䈀甀最开䌀氀攀愀爀䘀椀氀攀猀∀ऀ∀䈀漀爀爀愀爀 愀爀挀栀椀瘀漀猀∀ഀഀ
"[english]GameUI_Bug_ClearFiles"	"Clear files"਍∀䜀愀洀攀唀䤀开䈀甀最开䈀匀倀开䘀椀氀攀∀ऀ∀愀爀挀栀椀瘀漀 ⸀戀猀瀀∀ഀഀ
"[english]GameUI_Bug_BSP_File"	".bsp file"਍∀䜀愀洀攀唀䤀开䈀甀最开嘀䴀䘀开䘀椀氀攀∀ऀ∀愀爀挀栀椀瘀漀 ⸀瘀洀昀∀ഀഀ
"[english]GameUI_Bug_VMF_File"	".vmf file"਍∀䜀愀洀攀唀䤀开䈀甀最开䤀渀挀氀甀搀攀开䈀匀倀∀ऀ∀䤀渀挀氀甀椀爀 ⸀戀猀瀀∀ഀഀ
"[english]GameUI_Bug_Include_BSP"	"Include .bsp"਍∀䜀愀洀攀唀䤀开䈀甀最开䤀渀挀氀甀搀攀开嘀䴀䘀∀ऀ∀䤀渀挀氀甀椀爀 ⸀瘀洀昀∀ഀഀ
"[english]GameUI_Bug_Include_VMF"	"Include .vmf"਍∀䜀愀洀攀唀䤀开䈀甀最开䤀渀挀氀甀搀攀䘀椀氀攀∀ऀ∀䤀渀挀氀甀椀爀 愀爀挀栀椀瘀漀⸀⸀⸀∀ഀഀ
"[english]GameUI_Bug_IncludeFile"	"Include file..."਍∀䜀愀洀攀唀䤀开䐀堀开䰀攀瘀攀氀∀ऀ∀一椀瘀攀氀 䐀椀爀攀挀琀堀 搀攀 栀愀爀搀眀愀爀攀㨀∀ഀഀ
"[english]GameUI_DX_Level"	"Hardware DirectX level:"਍∀䜀愀洀攀唀䤀开䐀堀开䤀渀猀琀愀氀氀攀搀∀ऀ∀一椀瘀攀氀 䐀椀爀攀挀琀堀 搀攀 猀漀昀琀眀愀爀攀㨀∀ഀഀ
"[english]GameUI_DX_Installed"	"Software DirectX level:"਍∀䜀愀洀攀唀䤀开䴀漀搀攀氀开䐀攀琀愀椀氀∀ऀ∀䐀攀琀愀氀氀攀 搀攀 洀漀搀攀氀漀猀∀ഀഀ
"[english]GameUI_Model_Detail"	"Model detail"਍∀䜀愀洀攀唀䤀开吀攀砀琀甀爀攀开䐀攀琀愀椀氀∀ऀ∀䐀攀琀愀氀氀攀猀 搀攀 琀攀砀琀甀爀愀猀∀ഀഀ
"[english]GameUI_Texture_Detail"	"Texture detail"਍∀䜀愀洀攀唀䤀开䄀渀琀椀愀氀椀愀猀椀渀最开䴀漀搀攀∀ऀ∀䴀漀搀漀 猀甀愀瘀椀稀愀搀漀∀ഀഀ
"[english]GameUI_Antialiasing_Mode"	"Antialiasing mode"਍∀䜀愀洀攀唀䤀开䘀椀氀琀攀爀椀渀最开䴀漀搀攀∀ऀ∀䴀漀搀漀 搀攀 昀椀氀琀爀漀∀ഀഀ
"[english]GameUI_Filtering_Mode"	"Filtering mode"਍∀䜀愀洀攀唀䤀开圀愀琀攀爀开䐀攀琀愀椀氀∀ऀ∀䐀攀琀愀氀氀攀猀 搀攀氀 愀最甀愀∀ഀഀ
"[english]GameUI_Water_Detail"	"Water detail"਍∀䜀愀洀攀唀䤀开匀栀愀搀漀眀开䐀攀琀愀椀氀∀ऀ∀䐀攀琀愀氀氀攀猀 搀攀 猀漀洀戀爀愀猀∀ഀഀ
"[english]GameUI_Shadow_Detail"	"Shadow detail"਍∀䜀愀洀攀唀䤀开圀愀椀琀开䘀漀爀开嘀匀礀渀挀∀ऀ∀䔀猀瀀攀爀愀 愀 氀愀 猀椀渀挀⸀ 瘀攀爀琀椀挀愀氀∀ഀഀ
"[english]GameUI_Wait_For_VSync"	"Wait for vertical sync"਍∀䜀愀洀攀唀䤀开匀栀愀搀攀爀开䐀攀琀愀椀氀∀ऀ∀䐀攀琀愀氀氀攀猀 搀攀氀 猀漀洀戀爀攀愀搀漀爀∀ഀഀ
"[english]GameUI_Shader_Detail"	"Shader detail"਍∀䜀愀洀攀唀䤀开䌀漀氀漀爀开䌀漀爀爀攀挀琀椀漀渀∀ऀ∀䌀漀爀爀攀挀挀椀渀 搀攀 挀漀氀漀爀∀ഀഀ
"[english]GameUI_Color_Correction"	"Color Correction"਍∀䜀愀洀攀唀䤀开一漀伀瀀琀椀漀渀猀夀攀琀∀ऀ∀㰀 愀切渀 渀漀 栀愀礀 漀瀀挀椀漀渀攀猀 㸀∀ഀഀ
"[english]GameUI_NoOptionsYet"	"< no options yet >"਍∀䜀愀洀攀唀䤀开一漀渀攀∀ऀ∀䐀攀猀愀挀琀椀瘀愀搀漀∀ഀഀ
"[english]GameUI_None"	"None"਍∀䜀愀洀攀唀䤀开䈀椀氀椀渀攀愀爀∀ऀ∀䈀椀氀椀渀攀愀氀∀ഀഀ
"[english]GameUI_Bilinear"	"Bilinear"਍∀䜀愀洀攀唀䤀开吀爀椀氀椀渀攀愀爀∀ऀ∀吀爀椀氀椀渀攀愀氀∀ഀഀ
"[english]GameUI_Trilinear"	"Trilinear"਍∀䜀愀洀攀唀䤀开䄀渀椀猀漀琀爀漀瀀椀挀㈀堀∀ऀ∀䄀渀椀猀漀琀爀瀀椀挀漀 ㈀堀∀ഀഀ
"[english]GameUI_Anisotropic2X"	"Anisotropic 2X"਍∀䜀愀洀攀唀䤀开䄀渀椀猀漀琀爀漀瀀椀挀㐀堀∀ऀ∀䄀渀椀猀漀琀爀瀀椀挀漀 㐀堀∀ഀഀ
"[english]GameUI_Anisotropic4X"	"Anisotropic 4X"਍∀䜀愀洀攀唀䤀开䄀渀椀猀漀琀爀漀瀀椀挀㠀堀∀ऀ∀䄀渀椀猀漀琀爀瀀椀挀漀 㠀堀∀ഀഀ
"[english]GameUI_Anisotropic8X"	"Anisotropic 8X"਍∀䜀愀洀攀唀䤀开䄀渀椀猀漀琀爀漀瀀椀挀㄀㘀堀∀ऀ∀䄀渀椀猀漀琀爀瀀椀挀漀 ㄀㘀堀∀ഀഀ
"[english]GameUI_Anisotropic16X"	"Anisotropic 16X"਍∀䜀愀洀攀唀䤀开㈀堀∀ऀ∀㈀砀 䴀匀䄀䄀∀ഀഀ
"[english]GameUI_2X"	"2x MSAA"਍∀䜀愀洀攀唀䤀开㐀堀∀ऀ∀㐀砀 䴀匀䄀䄀∀ഀഀ
"[english]GameUI_4X"	"4x MSAA"਍∀䜀愀洀攀唀䤀开㘀堀∀ऀ∀㘀砀 䴀匀䄀䄀∀ഀഀ
"[english]GameUI_6X"	"6x MSAA"਍∀䜀愀洀攀唀䤀开㠀堀∀ऀ∀㠀砀 䴀匀䄀䄀∀ഀഀ
"[english]GameUI_8X"	"8x MSAA"਍∀䜀愀洀攀唀䤀开㠀堀开䌀匀䄀䄀∀ऀ∀㠀砀 䌀匀䄀䄀∀ഀഀ
"[english]GameUI_8X_CSAA"	"8x CSAA"਍∀䜀愀洀攀唀䤀开㄀㘀堀开䌀匀䄀䄀∀ऀ∀㄀㘀砀 䌀匀䄀䄀∀ഀഀ
"[english]GameUI_16X_CSAA"	"16x CSAA"਍∀䜀愀洀攀唀䤀开㄀㘀堀儀开䌀匀䄀䄀∀ऀ∀㄀㘀砀儀 䌀匀䄀䄀∀ഀഀ
"[english]GameUI_16XQ_CSAA"	"16xQ CSAA"਍∀䜀愀洀攀唀䤀开刀攀挀漀洀洀攀渀搀攀搀匀攀琀琀椀渀最猀∀ऀ∀⨀ 䌀漀渀昀椀最甀爀愀挀椀渀 爀攀挀漀洀攀渀搀愀搀愀 瀀愀爀愀 琀甀 猀椀猀琀攀洀愀∀ഀഀ
"[english]GameUI_RecommendedSettings"	"* Setting recommended for your system"਍∀䜀愀洀攀唀䤀开䈀氀漀漀洀∀ऀ∀唀猀愀爀 攀昀⸀ 搀攀 爀攀猀瀀氀愀渀搀漀爀 挀甀愀渀搀漀 攀猀琀 搀椀猀瀀漀渀椀戀氀攀∀ഀഀ
"[english]GameUI_Bloom"	"Use 'bloom' effect when available"਍∀䜀愀洀攀唀䤀开䠀䐀刀∀ऀ∀䠀䐀刀 ⠀愀氀琀漀 爀愀渀最漀 搀椀渀洀⸀⤀∀ഀഀ
"[english]GameUI_HDR"	"High Dynamic Range"਍∀䜀愀洀攀唀䤀开栀搀爀开氀攀瘀攀氀　∀ऀ∀匀椀渀 䠀䐀刀∀ഀഀ
"[english]GameUI_hdr_level0"	"None"਍∀䜀愀洀攀唀䤀开栀搀爀开氀攀瘀攀氀㄀∀ऀ∀刀攀猀瀀氀愀渀搀漀爀 ⠀猀攀最切渀 倀䌀⤀∀ഀഀ
"[english]GameUI_hdr_level1"	"Bloom (if available)"਍∀䜀愀洀攀唀䤀开栀搀爀开氀攀瘀攀氀㈀∀ऀ∀䌀漀洀瀀氀攀琀漀 ⠀猀攀最切渀 倀䌀⤀∀ഀഀ
"[english]GameUI_hdr_level2"	"Full (if available)"਍∀䜀愀洀攀唀䤀开栀搀爀开氀攀瘀攀氀㌀∀ऀ∀䄀洀瀀氀椀愀搀漀 ⠀猀攀最切渀 倀䌀⤀∀ഀഀ
"[english]GameUI_hdr_level3"	"Expanded (if available)"਍∀䜀愀洀攀唀䤀开䠀䐀刀开一漀琀攀䄀戀漀甀琀䴀愀瀀猀∀ऀ∀⠀䰀漀猀 攀昀攀挀琀漀猀 䠀䐀刀 猀漀氀漀 愀瀀愀爀攀挀攀渀 攀渀 氀漀猀 洀愀瀀愀猀 䠀䐀刀⤀∀ഀഀ
"[english]GameUI_HDR_NoteAboutMaps"	"(HDR effects appear only in HDR maps)"਍∀䜀愀洀攀唀䤀开䴀漀琀椀漀渀䈀氀甀爀∀ऀ∀䐀攀猀攀渀昀漀焀甀攀 洀漀瘀椀洀椀攀渀琀漀∀ഀഀ
"[english]GameUI_MotionBlur"	"Motion Blur"਍∀䜀愀洀攀唀䤀开䰀愀甀渀挀栀䈀攀渀挀栀洀愀爀欀∀ऀ∀倀刀唀䔀䈀䄀 䐀䔀 刀䔀一䐀䤀䴀䤀䔀一吀伀 䐀䔀 嘀䤀䐀䔀伀∀ഀഀ
"[english]GameUI_LaunchBenchmark"	"VIDEO STRESS TEST"਍∀䜀愀洀攀唀䤀开䰀愀甀渀挀栀䈀攀渀挀栀洀愀爀欀嘀椀搀攀漀倀愀渀攀氀∀ऀ∀䌀漀洀椀攀渀稀愀 氀愀 瀀爀甀攀戀愀 搀攀 爀攀渀搀椀洀椀攀渀琀漀⸀⸀⸀∀ഀഀ
"[english]GameUI_LaunchBenchmarkVideoPanel"	"Begin stress test..."਍∀䜀愀洀攀唀䤀开匀琀愀爀琀䈀攀渀挀栀洀愀爀欀∀ऀ∀䌀漀洀攀渀稀愀爀 氀愀 瀀爀甀攀戀愀 搀攀 爀攀渀搀椀洀椀攀渀琀漀 搀攀 瘀椀搀攀漀∀ഀഀ
"[english]GameUI_StartBenchmark"	"Begin video stress test"਍∀䜀愀洀攀唀䤀开䰀愀甀渀挀栀䈀攀渀挀栀洀愀爀欀开吀椀琀氀攀∀ऀ∀倀刀唀䔀䈀䄀 䐀䔀 刀䔀一䐀䤀䴀䤀䔀一吀伀 䐀䔀䰀 䠀䄀刀䐀圀䄀刀䔀 䐀䔀 嘀䤀䐀䔀伀∀ഀഀ
"[english]GameUI_LaunchBenchmark_Title"	"VIDEO HARDWARE STRESS TEST"਍∀䜀愀洀攀唀䤀开䰀愀甀渀挀栀䈀攀渀挀栀洀愀爀欀开䤀渀昀漀∀ऀ∀䔀猀琀愀 瀀爀甀攀戀愀 搀攀 爀攀渀搀椀洀椀攀渀琀漀 洀攀搀椀爀 氀愀 昀爀攀挀甀攀渀挀椀愀 搀攀 椀洀愀最攀渀 洀攀搀椀愀 ⠀攀渀 昀漀琀漀最爀愀洀愀猀 瀀漀爀 猀攀最甀渀搀漀⤀ 愀氀 最攀渀攀爀愀爀 攀氀攀洀攀渀琀漀猀 攀渀 攀氀 洀漀琀漀爀 匀漀甀爀挀攀⸀ 䄀氀 昀椀渀愀氀 搀攀 氀愀 瀀爀甀攀戀愀 瀀漀搀爀猀 琀爀愀渀猀洀椀琀椀爀 琀甀猀 爀攀猀甀氀琀愀搀漀猀 愀 嘀愀氀瘀攀⸀ 尀渀䴀猀 愀搀攀氀愀渀琀攀Ⰰ 栀愀戀爀 甀渀愀 瀀最椀渀愀 圀攀戀 搀椀猀瀀漀渀椀戀氀攀 挀漀渀 氀漀猀 爀攀猀甀氀琀愀搀漀猀 挀漀洀瀀椀氀愀搀漀猀⸀∀ഀഀ
"[english]GameUI_LaunchBenchmark_Info"	"This stress test will measure your average framerate while rendering elements in the Source engine. At the end of the test you will be able to upload your results to Valve. \nLater, there will be a web page available with the compiled results."਍∀䜀愀洀攀唀䤀开䈀攀渀挀栀洀愀爀欀刀攀猀甀氀琀猀开吀椀琀氀攀∀ऀ∀刀䔀匀唀䰀吀䄀䐀伀匀 䐀䔀 䰀䄀 倀刀唀䔀䈀䄀∀ഀഀ
"[english]GameUI_BenchmarkResults_Title"	"TEST RESULTS"਍∀䜀愀洀攀唀䤀开䈀攀渀挀栀洀愀爀欀刀攀猀甀氀琀猀开䤀渀昀漀∀ऀ∀吀甀 昀爀攀挀甀攀渀挀椀愀 搀攀 椀洀愀最攀渀 洀攀搀椀愀 搀甀爀愀渀琀攀 氀愀 瀀爀甀攀戀愀 搀攀 爀攀渀搀椀洀椀攀渀琀漀 昀甀攀 ─昀爀愀洀攀爀愀琀攀─ 昀瀀猀⸀ 匀椀 搀攀挀椀搀攀猀 琀爀愀渀猀洀椀琀椀爀 琀甀猀 搀愀琀漀猀Ⰰ 攀渀瘀椀愀爀猀 椀渀昀漀爀洀愀挀椀渀 猀漀戀爀攀 攀氀 琀椀瀀漀 礀 瘀攀氀漀挀椀搀愀搀 搀攀 琀甀 䌀倀唀Ⰰ 氀愀 挀愀渀琀椀搀愀搀 搀攀 刀䄀䴀 礀 攀氀 栀愀爀搀眀愀爀攀 搀攀 瘀椀搀攀漀 猀漀戀爀攀 攀氀 焀甀攀 猀攀 爀攀愀氀椀稀 攀猀琀愀 瀀爀甀攀戀愀⸀∀ഀഀ
"[english]GameUI_BenchmarkResults_Info"	"Your average framerate during the stress test was %framerate% fps. By choosing to upload your data you will be sending information about the type and speed of your CPU, amount of RAM, and the video hardware this test was run on."਍∀䜀愀洀攀唀䤀开䈀攀渀挀栀洀愀爀欀刀攀猀甀氀琀猀开唀瀀氀漀愀搀一漀眀∀ऀ∀吀爀愀渀猀洀椀琀椀爀 爀攀猀甀氀琀愀搀漀猀 愀 嘀愀氀瘀攀∀ഀഀ
"[english]GameUI_BenchmarkResults_UploadNow"	"Upload results to Valve"਍∀䜀愀洀攀唀䤀开䄀搀樀甀猀琀䜀愀洀洀愀∀ऀ∀䄀樀甀猀琀愀爀 渀椀瘀攀氀 搀攀氀 戀爀椀氀氀漀⸀⸀⸀∀ഀഀ
"[english]GameUI_AdjustGamma"	"Adjust brightness levels..."਍∀䜀愀洀攀唀䤀开䄀搀樀甀猀琀䜀愀洀洀愀开吀椀琀氀攀∀ऀ∀䄀䨀唀匀吀䄀刀 一䤀嘀䔀䰀 䐀䔀䰀 䈀刀䤀䰀䰀伀∀ഀഀ
"[english]GameUI_AdjustGamma_Title"	"ADJUST BRIGHTNESS LEVELS"਍∀䜀愀洀攀唀䤀开䐀椀猀瀀氀愀礀吀嘀∀ऀ∀吀攀氀攀瘀椀猀椀渀∀ഀഀ
"[english]GameUI_DisplayTV"	"Television"਍∀䜀愀洀攀唀䤀开䐀椀猀瀀氀愀礀䴀漀渀椀琀漀爀∀ऀ∀䴀漀渀椀琀漀爀 搀攀 漀爀搀攀渀愀搀漀爀∀ഀഀ
"[english]GameUI_DisplayMonitor"	"Computer Monitor"਍∀䜀愀洀攀唀䤀开吀攀猀琀匀瀀攀愀欀攀爀猀圀愀爀渀椀渀最开吀椀琀氀攀∀ऀ∀倀爀漀戀愀爀 氀愀 挀漀渀昀椀最甀爀愀挀椀渀 搀攀 氀漀猀 愀氀琀愀瘀漀挀攀猀⸀∀ഀഀ
"[english]GameUI_TestSpeakersWarning_Title"	"Test Speaker Settings"਍∀䜀愀洀攀唀䤀开吀攀猀琀匀瀀攀愀欀攀爀猀圀愀爀渀椀渀最开䤀渀昀漀∀ऀ∀䄀氀 瀀爀漀戀愀爀 氀愀 挀漀渀昀椀最甀爀愀挀椀渀 搀攀 氀漀猀 愀氀琀愀瘀漀挀攀猀 猀攀 琀攀 搀攀猀挀漀渀攀挀琀愀爀 搀攀氀 樀甀攀最漀 攀渀 挀甀爀猀漀⸀∀ഀഀ
"[english]GameUI_TestSpeakersWarning_Info"	"Testing speaker settings will disconnect you from the current game."਍∀䜀愀洀攀唀䤀开吀攀猀琀匀瀀攀愀欀攀爀猀圀愀爀渀椀渀最开伀欀䈀甀琀琀漀渀∀ऀ∀䔀樀攀挀甀琀愀爀 瀀爀甀攀戀愀 搀攀 氀漀猀 愀氀琀愀瘀漀挀攀猀∀ഀഀ
"[english]GameUI_TestSpeakersWarning_OkButton"	"Run Speaker Test"਍∀䜀愀洀攀唀䤀开吀攀猀琀匀瀀攀愀欀攀爀猀圀愀爀渀椀渀最开䌀愀渀挀攀氀䈀甀琀琀漀渀∀ऀ∀䌀愀渀挀攀氀愀爀∀ഀഀ
"[english]GameUI_TestSpeakersWarning_CancelButton"	"Cancel"਍∀䜀愀洀攀唀䤀开䜀愀洀洀愀䤀渀昀漀∀ऀ∀䄀樀甀猀琀愀 攀氀 挀漀渀琀爀漀氀 搀攀猀氀椀稀愀渀琀攀 栀愀猀琀愀 焀甀攀 氀愀猀 琀爀攀猀 氀渀攀愀猀 搀攀 琀攀砀琀漀 搀攀 愀戀愀樀漀 猀攀愀渀 瘀椀猀椀戀氀攀猀⸀∀ഀഀ
"[english]GameUI_GammaInfo"	"Adjust the slider until all three lines of text below are visible."਍∀䜀愀洀攀唀䤀开匀愀瘀攀䄀渀搀儀甀椀琀儀甀攀爀礀开䤀渀昀漀∀ऀ∀뼀䐀攀猀攀愀猀 最甀愀爀搀愀爀 氀愀 瀀愀爀琀椀搀愀 愀挀琀甀愀氀 愀渀琀攀猀 搀攀 猀愀氀椀爀㼀∀ഀഀ
"[english]GameUI_SaveAndQuitQuery_Info"	"Do you wish to save the current game before exiting?"਍∀䜀愀洀攀唀䤀开匀愀瘀攀䄀渀搀儀甀椀琀∀ऀ∀䜀甀愀爀搀愀爀∀ഀഀ
"[english]GameUI_SaveAndQuit"	"Save"਍∀䜀愀洀攀唀䤀开䐀漀渀琀匀愀瘀攀䄀渀搀儀甀椀琀∀ऀ∀一漀 最甀愀爀搀愀爀∀ഀഀ
"[english]GameUI_DontSaveAndQuit"	"Don't save"਍∀䜀愀洀攀唀䤀开䌀愀瀀琀椀漀渀椀渀最∀ऀ∀匀甀戀琀琀甀氀漀猀∀ഀഀ
"[english]GameUI_Captioning"	"Captioning"਍∀䜀愀洀攀唀䤀开一漀䌀氀漀猀攀搀䌀愀瀀琀椀漀渀猀∀ऀ∀匀椀渀 猀甀戀琀琀甀氀漀猀∀ഀഀ
"[english]GameUI_NoClosedCaptions"	"No captions"਍∀䜀愀洀攀唀䤀开匀甀戀琀椀琀氀攀猀∀ऀ∀匀甀戀琀琀甀氀漀猀 ⠀猀漀氀漀 搀椀氀漀最漀⤀∀ऀ嬀␀圀䤀一㌀㈀崀ഀഀ
"[english]GameUI_Subtitles"	"Subtitles (dialog only)"਍∀䜀愀洀攀唀䤀开匀甀戀琀椀琀氀攀猀∀ऀ∀匀甀戀琀琀甀氀漀猀∀ऀ嬀␀堀㌀㘀　崀ഀഀ
"[english]GameUI_Subtitles"	"Subtitles"਍∀䜀愀洀攀唀䤀开匀甀戀琀椀琀氀攀猀䄀渀搀匀漀甀渀搀䔀昀昀攀挀琀猀∀ऀ∀匀甀戀琀琀甀氀漀猀∀ഀഀ
"[english]GameUI_SubtitlesAndSoundEffects"	"Closed Captions"਍∀䜀愀洀攀唀䤀开倀愀甀猀攀搀∀ऀ∀䔀一 倀䄀唀匀䄀∀ഀഀ
"[english]GameUI_Paused"	"PAUSED"਍∀䜀愀洀攀唀䤀开匀瀀爀愀礀开䤀洀瀀漀爀琀开䔀爀爀漀爀开吀椀琀氀攀∀ऀ∀䔀爀爀漀爀 搀攀 椀洀瀀漀爀琀愀挀椀渀 搀攀 愀攀爀漀猀漀氀∀ഀഀ
"[english]GameUI_Spray_Import_Error_Title"	"Spray Import Error"਍∀䜀愀洀攀唀䤀开匀瀀爀愀礀开䤀洀瀀漀爀琀开䔀爀爀漀爀开刀攀愀搀椀渀最开䤀洀愀最攀∀ऀ∀䔀爀爀漀爀 愀氀 氀攀攀爀 氀愀 椀洀愀最攀渀 搀攀 漀爀椀最攀渀⸀ 䔀氀 愀爀挀栀椀瘀漀 搀攀 椀洀愀最攀渀 瀀甀攀搀攀 攀猀琀愀爀 搀愀愀搀漀 漀 攀氀 昀漀爀洀愀琀漀 瀀甀攀搀攀 渀漀 猀攀爀 攀氀 挀漀爀爀攀挀琀漀⸀∀ഀഀ
"[english]GameUI_Spray_Import_Error_Reading_Image"	"Error reading source image. Image file is possibly corrupt or improperly formated"਍∀䜀愀洀攀唀䤀开匀瀀爀愀礀开䤀洀瀀漀爀琀开䤀洀愀最攀开圀爀漀渀最开匀椀稀攀∀ऀ∀䔀氀 琀愀洀愀漀 搀攀 氀愀 椀洀愀最攀渀 搀攀 漀爀椀最攀渀 渀漀 攀猀 挀漀爀爀攀挀琀漀⸀  䰀漀猀 瘀愀氀漀爀攀猀 愀搀洀椀琀椀搀漀猀 搀攀 愀氀琀甀爀愀 礀 愀渀挀栀甀爀愀 攀渀 瀀砀攀氀攀猀 猀漀渀 ㈀㔀㘀Ⰰ ㄀㈀㠀Ⰰ 㘀㐀Ⰰ ㌀㈀Ⰰ ㄀㘀Ⰰ 㠀Ⰰ 㐀Ⰰ ㈀ 礀 ㄀⸀∀ഀഀ
"[english]GameUI_Spray_Import_Image_Wrong_Size"	"Source image is not the correct size.  Valid height and width values in pixels are 256, 128, 64, 32, 16, 8, 4, 2, and 1."਍∀䜀愀洀攀唀䤀开匀瀀爀愀礀开䤀洀瀀漀爀琀开䔀爀爀漀爀开䴀攀洀漀爀礀∀ऀ∀一漀 猀攀 瀀甀攀搀攀 愀猀椀最渀愀爀 洀攀洀漀爀椀愀 猀甀昀椀挀椀攀渀琀攀 瀀愀爀愀 氀愀 挀漀渀瘀攀爀猀椀渀⸀ 䄀爀挀栀椀瘀漀 搀攀 椀洀愀最攀渀 瀀漀猀椀戀氀攀洀攀渀琀攀 搀愀愀搀漀⸀∀ഀഀ
"[english]GameUI_Spray_Import_Error_Memory"	"Unable to allocate enough memory for conversion. Image file possibly corrupt."਍∀䜀愀洀攀唀䤀开匀瀀爀愀礀开䤀洀瀀漀爀琀开䔀爀爀漀爀开䤀洀愀最攀开䘀椀氀攀开䌀漀爀爀甀瀀琀∀ऀ∀䄀爀挀栀椀瘀漀 搀攀 椀洀愀最攀渀 搀愀愀搀漀⸀∀ഀഀ
"[english]GameUI_Spray_Import_Error_Image_File_Corrupt"	"Image file is corrupt."਍∀䜀愀洀攀唀䤀开匀瀀爀愀礀开䤀洀瀀漀爀琀开䔀爀爀漀爀开䈀䴀倀开䘀漀爀洀愀琀开一漀琀开匀甀瀀瀀漀爀琀攀搀∀ऀ∀䔀氀 昀漀爀洀愀琀漀 䈀䴀倀 搀攀 攀猀琀攀 愀爀挀栀椀瘀漀 渀漀 攀猀 挀漀洀瀀愀琀椀戀氀攀⸀ 䰀漀猀 昀漀爀洀愀琀漀猀 䈀䴀倀 挀漀洀瀀愀琀椀戀氀攀猀 猀漀渀 刀䜀䈀 搀攀 ㈀㐀 戀椀琀猀 礀 刀䜀䈀䄀 搀攀 ㌀㈀ 戀椀琀猀⸀∀ഀഀ
"[english]GameUI_Spray_Import_Error_BMP_Format_Not_Supported"	"This file's BMP format is not supported.  Supported BMP formats are 24-bit RGB and 32-bit RGBA."਍∀䜀愀洀攀唀䤀开匀瀀爀愀礀开䤀洀瀀漀爀琀开䔀爀爀漀爀开吀䜀䄀开䘀漀爀洀愀琀开一漀琀开匀甀瀀瀀漀爀琀攀搀∀ऀ∀䔀氀 昀漀爀洀愀琀漀 吀䜀䄀 搀攀 攀猀琀攀 愀爀挀栀椀瘀漀 渀漀 攀猀 挀漀洀瀀愀琀椀戀氀攀⸀  䰀漀猀 昀漀爀洀愀琀漀猀 吀䜀䄀 挀漀洀瀀愀琀椀戀氀攀猀 猀漀渀 刀䜀䈀 搀攀 ㈀㐀 戀椀琀猀 礀 刀䜀䈀䄀 搀攀 ㌀㈀ 戀椀琀猀⸀∀ഀഀ
"[english]GameUI_Spray_Import_Error_TGA_Format_Not_Supported"	"This file's TGA format is not supported.  Supported TGA formats are 24-bit RGB and 32-bit RGBA."਍∀䜀愀洀攀唀䤀开匀瀀爀愀礀开䤀洀瀀漀爀琀开䔀爀爀漀爀开圀爀椀琀椀渀最开吀攀洀瀀开伀甀琀瀀甀琀∀ऀ∀䔀爀爀漀爀 愀氀 挀爀攀愀爀 愀爀挀栀椀瘀漀 琀攀洀瀀漀爀愀氀⸀∀ഀഀ
"[english]GameUI_Spray_Import_Error_Writing_Temp_Output"	"Error creating temporary file."਍∀䜀愀洀攀唀䤀开匀瀀爀愀礀开䤀洀瀀漀爀琀开䔀爀爀漀爀开䌀愀渀琀开䰀漀愀搀开嘀吀䔀堀开䐀䰀䰀∀ऀ∀一漀 猀攀 瀀甀攀搀攀 挀愀爀最愀爀 瘀琀攀砀开搀氀氀⸀搀氀氀⸀ 刀攀椀渀椀挀椀愀 匀琀攀愀洀 瀀愀爀愀 漀戀琀攀渀攀爀 氀愀猀 切氀琀椀洀愀猀 愀挀琀甀愀氀椀稀愀挀椀漀渀攀猀⸀∀ഀഀ
"[english]GameUI_Spray_Import_Error_Cant_Load_VTEX_DLL"	"Unable to load vtex_dll.dll.  Try restarting steam to get the latest updates."਍∀䜀愀洀攀唀䤀开匀瀀爀愀礀开䤀洀瀀漀爀琀开䔀爀爀漀爀开圀爀椀琀椀渀最开伀甀琀瀀甀琀∀ऀ∀一漀 猀攀 瀀甀攀搀攀 最爀愀戀愀爀 攀氀 愀爀挀栀椀瘀漀 猀瀀爀愀礀 搀攀 猀愀氀椀搀愀⸀  䔀猀 瀀漀猀椀戀氀攀 焀甀攀 攀氀 甀猀甀愀爀椀漀 愀挀琀甀愀氀 渀漀 琀攀渀最愀 瀀攀爀洀椀猀漀⸀∀ഀഀ
"[english]GameUI_Spray_Import_Error_Writing_Output"	"Unable to write output spray file.  It's possible the current user doesn't have permission."਍∀䜀愀洀攀唀䤀开䤀洀瀀漀爀琀匀瀀爀愀礀䔀氀氀椀瀀猀椀猀∀ऀ∀䤀洀瀀漀爀琀愀爀 愀攀爀漀猀漀氀⸀⸀⸀∀ഀഀ
"[english]GameUI_ImportSprayEllipsis"	"Import Spray..."਍∀䜀愀洀攀唀䤀开䤀洀瀀漀爀琀匀瀀爀愀礀䤀洀愀最攀∀ऀ∀䤀洀瀀漀爀琀愀爀 椀洀愀最攀渀 搀攀 愀攀爀漀猀漀氀∀ഀഀ
"[english]GameUI_ImportSprayImage"	"Import Spray Image"਍∀䜀愀洀攀唀䤀开䄀氀氀开䤀洀愀最攀猀∀ऀ∀吀漀搀愀猀 氀愀猀 椀洀最攀渀攀猀 ⠀⨀⸀樀瀀最Ⰰ ⨀⸀戀洀瀀Ⰰ ⨀⸀琀最愀Ⰰ ⨀⸀瘀琀昀⤀∀ഀഀ
"[english]GameUI_All_Images"	"All Images (*.jpg,*.bmp,*.tga,*.vtf)"਍∀䜀愀洀攀唀䤀开䨀倀䔀䜀开䤀洀愀最攀猀∀ऀ∀䤀洀最攀渀攀猀 䨀倀䔀䜀 ⠀⨀⸀樀瀀最⤀∀ഀഀ
"[english]GameUI_JPEG_Images"	"JPEG Images (*.jpg)"਍∀䜀愀洀攀唀䤀开吀䜀䄀开䤀洀愀最攀猀∀ऀ∀䤀洀最攀渀攀猀 吀愀爀最愀 ⠀⨀⸀琀最愀⤀∀ഀഀ
"[english]GameUI_TGA_Images"	"Targa Images (*.tga)"਍∀䜀愀洀攀唀䤀开䈀䴀倀开䤀洀愀最攀猀∀ऀ∀䤀洀最攀渀攀猀 䈀椀琀洀愀瀀 ⠀⨀⸀戀洀瀀⤀∀ഀഀ
"[english]GameUI_BMP_Images"	"Bitmap Images (*.bmp)"਍∀䜀愀洀攀唀䤀开嘀吀䘀开䤀洀愀最攀猀∀ऀ∀䤀洀最攀渀攀猀 嘀吀䘀 ⠀⨀⸀瘀琀昀⤀∀ഀഀ
"[english]GameUI_VTF_Images"	"VTF Images (*.vtf)"਍∀䜀愀洀攀唀䤀开䤀洀瀀漀爀琀䈀漀渀甀猀䴀愀瀀猀䔀氀氀椀瀀猀椀猀∀ऀ∀䤀洀瀀漀爀琀愀爀 洀愀瀀愀猀 搀攀 戀漀渀椀昀椀挀愀挀椀渀⸀⸀⸀∀ഀഀ
"[english]GameUI_ImportBonusMapsEllipsis"	"Import Bonus Maps..."਍∀䜀愀洀攀唀䤀开䤀洀瀀漀爀琀䈀漀渀甀猀䴀愀瀀猀∀ऀ∀䤀洀瀀漀爀琀愀爀 洀愀瀀愀猀 搀攀 戀漀渀椀昀椀挀愀挀椀渀∀ഀഀ
"[english]GameUI_ImportBonusMaps"	"Import Bonus Maps"਍∀䜀愀洀攀唀䤀开䈀䴀娀开䘀椀氀攀猀∀ऀ∀䄀爀挀栀椀瘀漀猀 挀漀洀瀀爀椀洀椀搀漀猀 搀攀 洀愀瀀愀猀 搀攀 戀漀渀椀昀椀挀愀挀椀渀 ⠀⨀⸀戀洀稀⤀∀ഀഀ
"[english]GameUI_BMZ_Files"	"Bonus Map Zip Files (*.bmz)"਍∀䜀愀洀攀唀䤀开匀攀琀琀椀渀最刀攀焀甀椀爀攀猀䐀椀猀挀漀渀渀攀挀琀开吀椀琀氀攀∀ऀ∀伀倀䌀䤀伀一䔀匀 ⴀ 䄀嘀䤀匀伀∀ഀഀ
"[english]GameUI_SettingRequiresDisconnect_Title"	"OPTIONS - WARNING"਍∀䜀愀洀攀唀䤀开匀攀琀琀椀渀最刀攀焀甀椀爀攀猀䐀椀猀挀漀渀渀攀挀琀开䤀渀昀漀∀ऀ∀䄀氀 挀愀洀戀椀愀爀 攀猀琀愀 挀漀渀昀椀最甀爀愀挀椀渀 猀攀 琀攀 搀攀猀挀漀渀攀挀琀愀爀 搀攀氀 樀甀攀最漀 攀渀 挀甀爀猀漀⸀∀ഀഀ
"[english]GameUI_SettingRequiresDisconnect_Info"	"Changing this setting will disconnect you from the current game."਍∀䜀愀洀攀唀䤀开匀攀琀琀椀渀最䌀栀愀渀最攀䘀爀漀洀堀㌀㘀　䐀愀猀栀戀漀愀爀搀开吀椀琀氀攀∀ऀ∀伀倀䌀䤀伀一䔀匀∀ഀഀ
"[english]GameUI_SettingChangeFromX360Dashboard_Title"	"OPTIONS"਍∀䜀愀洀攀唀䤀开匀攀琀琀椀渀最䌀栀愀渀最攀䘀爀漀洀堀㌀㘀　䐀愀猀栀戀漀愀爀搀开䤀渀昀漀∀ऀ∀䔀猀琀愀 漀瀀挀椀渀 猀漀氀漀 瀀甀攀搀攀 挀漀渀昀椀最甀爀愀爀猀攀 搀攀猀搀攀 氀愀 䤀渀琀攀爀昀愀稀 堀戀漀砀 ㌀㘀　⸀∀ഀഀ
"[english]GameUI_SettingChangeFromX360Dashboard_Info"	"This setting can only be changed from the Xbox 360 Dashboard."਍∀䜀愀洀攀唀䤀开䐀氀最开䌀栀攀挀欀椀渀最匀琀漀爀愀最攀䐀攀瘀椀挀攀∀ऀ∀䌀漀洀瀀爀漀戀愀渀搀漀 搀椀猀瀀漀猀椀琀椀瘀漀 搀攀 愀氀洀愀挀攀渀愀洀椀攀渀琀漀⸀⸀⸀∀ഀഀ
"[english]GameUI_Dlg_CheckingStorageDevice"	"Checking storage device..."਍∀䜀愀洀攀唀䤀开䌀栀愀瀀琀攀爀∀ऀ∀䌀䄀倀촀吀唀䰀伀∀ഀഀ
"[english]GameUI_Chapter"	"CHAPTER"਍∀嘀䄀䌀开䰀漀最最攀搀䤀渀䔀氀猀攀眀栀攀爀攀开吀椀琀氀攀∀ऀ∀䌀甀攀渀琀愀 甀琀椀氀椀稀愀搀愀 攀渀 漀琀爀漀 猀椀琀椀漀∀ഀഀ
"[english]VAC_LoggedInElsewhere_Title"	"Account Used Elsewhere"਍∀嘀䄀䌀开䰀漀最最攀搀䤀渀䔀氀猀攀眀栀攀爀攀刀攀愀猀漀渀∀ऀ∀䔀猀琀愀 挀甀攀渀琀愀 搀攀 匀琀攀愀洀 猀攀 栀愀 甀琀椀氀椀稀愀搀漀 瀀愀爀愀 挀漀渀攀挀琀愀爀猀攀 搀攀猀搀攀 漀琀爀漀 漀爀搀攀渀愀搀漀爀⸀ 倀愀爀愀 挀漀渀琀椀渀甀愀爀 甀琀椀氀椀稀愀渀搀漀 匀琀攀愀洀Ⰰ 搀攀戀攀猀 挀漀渀攀挀琀愀爀琀攀 搀攀 渀甀攀瘀漀⸀∀ഀഀ
"[english]VAC_LoggedInElsewhereReason"	"This Steam account has been used to log in from another computer. To continue using Steam, you need to log in again."਍∀䜀䄀䴀䔀唀䤀开䌀漀洀洀攀渀琀愀爀礀∀ऀ∀䌀漀洀攀渀琀愀爀椀漀∀ഀഀ
"[english]GAMEUI_Commentary"	"Commentary"਍∀䜀䄀䴀䔀唀䤀开䌀漀洀洀攀渀琀愀爀礀开伀渀∀ऀ∀䄀挀琀椀瘀愀搀漀 ⠀猀椀 搀椀猀瀀漀渀⸀⤀∀ഀഀ
"[english]GAMEUI_Commentary_On"	"On (where available)"਍∀䜀䄀䴀䔀唀䤀开䌀漀洀洀攀渀琀愀爀礀开伀昀昀∀ऀ∀䐀攀猀愀挀琀⸀∀ഀഀ
"[english]GAMEUI_Commentary_Off"	"Off"਍∀䜀䄀䴀䔀唀䤀开䌀漀洀洀攀渀琀愀爀礀䐀椀愀氀漀最吀椀琀氀攀∀ऀ∀䌀伀䴀䔀一吀䄀刀䤀伀∀ഀഀ
"[english]GAMEUI_CommentaryDialogTitle"	"COMMENTARY"਍∀䜀䄀䴀䔀唀䤀开䌀漀洀洀攀渀琀愀爀礀开䰀愀戀攀氀伀渀∀ऀ∀䴀伀䐀伀 䌀伀䴀䔀一吀䄀刀䤀伀㨀 䄀䌀吀䤀嘀䄀䐀伀∀ഀഀ
"[english]GAMEUI_Commentary_LabelOn"	"COMMENTARY MODE IS CURRENTLY: ON"਍∀䜀䄀䴀䔀唀䤀开䌀漀洀洀攀渀琀愀爀礀开䰀攀愀瘀攀伀渀∀ऀ∀䐀攀樀愀爀 挀漀洀攀渀琀⸀ 䄀䌀吀⸀∀ഀഀ
"[english]GAMEUI_Commentary_LeaveOn"	"Leave commentary ON"਍∀䜀䄀䴀䔀唀䤀开䌀漀洀洀攀渀琀愀爀礀开吀甀爀渀伀昀昀∀ऀ∀䐀䔀匀䄀䌀吀⸀ 挀漀洀攀渀琀愀爀椀漀∀ഀഀ
"[english]GAMEUI_Commentary_TurnOff"	"Turn commentary OFF"਍∀䜀䄀䴀䔀唀䤀开䌀漀洀洀攀渀琀愀爀礀开䰀愀戀攀氀伀昀昀∀ऀ∀䄀䠀伀刀䄀 䴀伀䐀伀 䌀伀䴀䔀一吀⸀㨀 䐀䔀匀䄀䌀吀䤀嘀䄀䐀伀∀ഀഀ
"[english]GAMEUI_Commentary_LabelOff"	"COMMENTARY MODE IS CURRENTLY: OFF"਍∀䜀䄀䴀䔀唀䤀开䌀漀洀洀攀渀琀愀爀礀开吀甀爀渀伀渀∀ऀ∀䄀䌀吀⸀ 挀漀洀攀渀琀愀爀椀漀∀ഀഀ
"[english]GAMEUI_Commentary_TurnOn"	"Turn commentary ON"਍∀䜀䄀䴀䔀唀䤀开䌀漀洀洀攀渀琀愀爀礀开䰀攀愀瘀攀伀昀昀∀ऀ∀䐀攀樀愀爀 挀漀洀⸀ 䐀䔀匀䄀䌀吀⸀∀ഀഀ
"[english]GAMEUI_Commentary_LeaveOff"	"Leave commentary OFF"਍∀䜀䄀䴀䔀唀䤀开倀漀猀琀䌀漀洀洀攀渀琀愀爀礀开䴀漀搀攀䰀愀戀攀氀伀渀∀ऀ∀䴀伀䐀伀 䌀伀䴀䔀一吀⸀㨀 䄀䌀吀䤀嘀䄀䐀伀∀ഀഀ
"[english]GAMEUI_PostCommentary_ModeLabelOn"	"COMMENTARY MODE IS: ON"਍∀䜀䄀䴀䔀唀䤀开倀漀猀琀䌀漀洀洀攀渀琀愀爀礀开䴀漀搀攀䰀愀戀攀氀伀昀昀∀ऀ∀䴀伀䐀伀 䌀伀䴀䔀一吀⸀㨀 䐀䔀匀䄀䌀吀⸀∀ഀഀ
"[english]GAMEUI_PostCommentary_ModeLabelOff"	"COMMENTARY MODE IS: OFF"਍∀䜀䄀䴀䔀唀䤀开倀漀猀琀䌀漀洀洀攀渀琀愀爀礀开漀瀀琀椀漀渀猀∀ऀ∀⠀倀愀爀愀 愀挀琀椀瘀愀爀 礀 搀攀猀愀挀琀椀瘀愀爀 攀氀 挀漀洀攀渀琀愀爀椀漀Ⰰ 猀攀氀攀挀挀椀漀渀愀 尀∀伀瀀挀椀漀渀攀猀尀∀ 攀渀 攀氀 洀攀渀切 瀀爀椀渀挀椀瀀愀氀⸀⤀∀ഀഀ
"[english]GAMEUI_PostCommentary_options"	"(To turn commentary on or off, select \"options\" from the main menu.)"਍∀䜀䄀䴀䔀唀䤀开䰀漀猀琀䌀漀愀猀琀䠀愀猀䌀漀洀洀攀渀琀愀爀礀∀ऀ∀䔀渀 䠀愀氀昀ⴀ䰀椀昀攀 ㈀㨀 䰀漀猀琀 䌀漀愀猀琀 猀攀 椀渀挀氀甀礀攀渀 挀漀洀攀渀琀愀爀椀漀猀 搀攀 愀甀搀椀漀 搀攀 氀漀猀 洀椀攀洀戀爀漀猀 搀攀氀 攀焀甀椀瀀漀 搀攀 搀攀猀愀爀爀漀氀氀漀 搀攀 嘀愀氀瘀攀⸀∀ഀഀ
"[english]GAMEUI_LostCoastHasCommentary"	"Half-Life 2: Lost Coast includes audio commentary, spoken by members of the Valve development team."਍∀䜀䄀䴀䔀唀䤀开䌀漀洀洀攀渀琀愀爀礀开圀栀愀琀䤀猀∀ऀ∀䔀氀 洀漀搀漀 挀漀洀攀渀琀愀爀椀漀 琀攀 瀀攀爀洀椀琀攀 愀挀挀攀搀攀爀 愀 渀漀搀漀猀 搀攀 椀渀昀漀爀洀愀挀椀渀 焀甀攀 挀漀渀琀椀攀渀攀渀 挀漀洀攀渀琀愀爀椀漀猀 最爀愀戀愀搀漀猀 瀀漀爀 氀漀猀 洀椀攀洀戀爀漀猀 搀攀氀 攀焀甀椀瀀漀 搀攀 搀攀猀愀爀爀漀氀氀漀 搀攀 嘀愀氀瘀攀⸀∀ഀഀ
"[english]GAMEUI_Commentary_WhatIs"	"Commentary mode allows access to information nodes, containing audio commentary spoken by members of the Valve development team."਍∀䜀䄀䴀䔀唀䤀开䌀漀洀洀攀渀琀愀爀礀开䠀漀眀吀漀唀猀攀∀ऀ∀倀愀爀愀 爀攀瀀爀漀搀甀挀椀爀 漀 搀攀琀攀渀攀爀 攀氀 渀漀搀漀 搀攀 甀渀 挀漀洀攀渀琀愀爀椀漀Ⰰ 愀瀀甀渀琀愀 挀漀渀 氀愀 洀椀爀愀 愀 挀甀愀氀焀甀椀攀爀 椀挀漀渀漀 搀攀 最氀漀戀漀 礀 瀀甀氀猀愀 氀愀 琀攀挀氀愀 唀匀䄀刀⸀∀ഀഀ
"[english]GAMEUI_Commentary_HowToUse"	"To start or stop a commentary node, aim your crosshairs at any balloon icon and then press your USE key."਍∀䜀䄀䴀䔀唀䤀开䌀漀洀洀攀渀琀愀爀礀开䠀漀眀吀漀唀猀攀开䄀琀琀愀挀欀∀ऀ∀倀愀爀愀 爀攀瀀爀漀搀甀挀椀爀 漀 搀攀琀攀渀攀爀 攀氀 渀漀搀漀 搀攀 甀渀 挀漀洀攀渀琀愀爀椀漀Ⰰ 愀瀀甀渀琀愀 挀漀渀 氀愀 洀椀爀愀 愀 挀甀愀氀焀甀椀攀爀 椀挀漀渀漀 搀攀 最氀漀戀漀 礀 瀀甀氀猀愀 氀愀 琀攀挀氀愀 搀攀 䄀吀䄀儀唀䔀 倀刀䤀一䌀䤀倀䄀䰀⸀∀ഀഀ
"[english]GAMEUI_Commentary_HowToUse_Attack"	"To start or stop a commentary node, aim your crosshairs at any balloon icon and then press your PRIMARY FIRE key."਍∀䜀䄀䴀䔀唀䤀开䌀伀䴀䴀䔀一吀䄀刀夀开䜀伀䐀∀ऀ∀⠀䌀甀愀渀搀漀 樀甀攀最甀攀猀 攀渀 洀漀搀漀 挀漀洀攀渀琀愀爀椀漀Ⰰ 猀攀爀猀 椀渀瘀甀氀渀攀爀愀戀氀攀 愀氀 搀愀漀 礀 渀漀 挀漀渀猀攀最甀椀爀猀 氀漀最爀漀猀⸀⤀∀ഀഀ
"[english]GAMEUI_COMMENTARY_GOD"	"(While playing the game in commentary mode, you will be invulnerable to damage and achievements will not be awarded.)"਍∀䜀䄀䴀䔀唀䤀开䌀漀洀洀攀渀琀愀爀礀开䌀漀渀猀漀氀攀开䔀砀瀀氀愀渀愀琀椀漀渀∀ऀ∀䰀漀猀 尀∀渀漀搀漀猀 搀攀 挀漀洀攀渀琀愀爀椀漀猀尀∀ 挀漀渀琀椀攀渀攀渀 挀漀洀攀渀琀愀爀椀漀猀 攀渀 愀甀搀椀漀 搀攀氀 攀焀甀椀瀀漀 搀攀 搀攀猀愀爀爀漀氀氀漀 搀攀 嘀愀氀瘀攀⸀ 倀愀爀愀 爀攀瀀爀漀搀甀挀椀爀 漀 搀攀琀攀渀攀爀 甀渀 渀漀搀漀Ⰰ 愀瀀甀渀琀愀 愀 挀甀愀氀焀甀椀攀爀 椀挀漀渀漀 搀攀 最氀漀戀漀 礀 瀀甀氀猀愀 攀氀 戀漀琀渀 唀匀䄀刀⸀ ⠀䴀椀攀渀琀爀愀猀 攀猀挀甀挀栀攀猀 甀渀 渀漀搀漀Ⰰ 猀攀爀猀 椀渀瘀甀氀渀攀爀愀戀氀攀 愀氀 搀愀漀⸀ 䔀渀 攀氀 洀漀搀漀 挀漀洀攀渀琀愀爀椀漀 渀漀 猀攀 瀀甀攀搀攀渀 挀漀渀猀攀最甀椀爀 氀漀最爀漀猀⸀⤀∀ഀഀ
"[english]GAMEUI_Commentary_Console_Explanation"	"'Commentary nodes' contain audio commentary by the Valve development team. To start or stop a node, aim at any balloon icon and press your USE button. (You will be invulnerable to damage while listening to a node. Achievements can not be earned in commentary mode.)"਍∀䜀䄀䴀䔀唀䤀开䄀甀搀椀漀匀瀀漀欀攀渀䰀愀渀最甀愀最攀∀ऀ∀䤀搀椀漀洀愀 搀攀 愀甀搀椀漀 ⠀瘀漀稀⤀∀ഀഀ
"[english]GAMEUI_AudioSpokenLanguage"	"Audio (spoken) language"਍∀䜀愀洀攀唀䤀开吀栀椀爀搀倀愀爀琀礀吀攀挀栀䌀爀攀搀椀琀猀∀ऀ∀䌀爀搀椀琀漀猀 搀攀 琀攀挀渀漀氀漀最愀 搀攀 琀攀爀挀攀爀漀猀∀ഀഀ
"[english]GameUI_ThirdPartyTechCredits"	"3rd party technology credits"਍∀䜀愀洀攀唀䤀开吀栀椀爀搀倀愀爀琀礀䄀甀搀椀漀开吀椀琀氀攀∀ऀ∀吀䔀䌀一伀䰀伀䜀촀䄀 䐀䔀 䄀唀䐀䤀伀 䐀䔀 吀䔀刀䌀䔀刀伀匀∀ഀഀ
"[english]GameUI_ThirdPartyAudio_Title"	"3rd PARTY AUDIO TECHNOLOGY"਍∀䜀愀洀攀唀䤀开吀栀椀爀搀倀愀爀琀礀嘀椀搀攀漀开吀椀琀氀攀∀ऀ∀吀䔀䌀一伀䰀伀䜀촀䄀 䐀䔀 嘀촀䐀䔀伀 䐀䔀 吀䔀刀䌀䔀刀伀匀∀ഀഀ
"[english]GameUI_ThirdPartyVideo_Title"	"3rd PARTY VIDEO TECHNOLOGY"਍∀䜀䄀䴀䔀唀䤀开刀攀焀甀椀爀攀猀刀攀猀琀愀爀琀∀ऀ∀⠀䠀愀礀 焀甀攀 爀攀椀渀椀挀椀愀爀⤀∀ഀഀ
"[english]GAMEUI_RequiresRestart"	"(Requires restart)"਍∀䜀愀洀攀唀䤀开䌀栀愀渀最攀䰀愀渀最甀愀最攀刀攀猀琀愀爀琀开伀欀䈀甀琀琀漀渀∀ऀ∀刀攀椀渀椀挀椀愀爀 愀栀漀爀愀∀ഀഀ
"[english]GameUI_ChangeLanguageRestart_OkButton"	"Restart Now"਍∀䜀愀洀攀唀䤀开䌀栀愀渀最攀䰀愀渀最甀愀最攀刀攀猀琀愀爀琀开䌀愀渀挀攀氀䈀甀琀琀漀渀∀ऀ∀䌀愀渀挀攀氀愀爀∀ഀഀ
"[english]GameUI_ChangeLanguageRestart_CancelButton"	"Cancel"਍∀䜀愀洀攀唀䤀开䌀栀愀渀最攀䰀愀渀最甀愀最攀刀攀猀琀愀爀琀开吀椀琀氀攀∀ऀ∀䌀䄀䴀䈀䤀䄀刀 䤀䐀䤀伀䴀䄀 䐀䔀 䄀唀䐀䤀伀∀ഀഀ
"[english]GameUI_ChangeLanguageRestart_Title"	"CHANGE SPOKEN AUDIO LANGUAGE"਍∀䜀愀洀攀唀䤀开䌀栀愀渀最攀䰀愀渀最甀愀最攀刀攀猀琀愀爀琀开䤀渀昀漀∀ऀ∀䔀猀 渀攀挀攀猀愀爀椀漀 爀攀椀渀椀挀椀愀爀 攀氀 樀甀攀最漀 瀀愀爀愀 挀愀洀戀椀愀爀 攀氀 椀搀椀漀洀愀 搀攀 愀甀搀椀漀⸀尀渀尀渀뼀儀甀椀攀爀攀猀 爀攀椀渀椀挀椀愀爀 愀栀漀爀愀㼀∀ഀഀ
"[english]GameUI_ChangeLanguageRestart_Info"	"The game must restart in order to change the spoken audio language.\n\nWould you like to restart now?"਍∀䜀愀洀攀唀䤀㘀㐀开㘀㐀䈀椀琀一漀琀椀挀攀∀ऀ∀䴀漀搀漀 愀挀琀椀瘀漀 搀攀 㘀㐀 戀椀琀猀∀ഀഀ
"[english]GameUI64_64BitNotice"	"64-bit mode active"਍∀䜀愀洀攀唀䤀开䰀漀愀搀䌀漀洀洀攀渀琀愀爀礀∀ऀ∀䌀伀䴀䔀一吀䄀刀䤀伀匀 䐀䔀 䰀伀匀 䐀䔀匀䄀刀刀伀䰀䰀䄀䐀伀刀䔀匀∀ഀഀ
"[english]GameUI_LoadCommentary"	"DEVELOPER COMMENTARY"਍∀䜀愀洀攀唀䤀开䰀漀愀搀䌀漀洀洀攀渀琀愀爀礀䠀攀氀瀀∀ऀ∀匀攀氀攀挀挀椀漀渀愀 甀渀愀 瀀椀猀琀愀 搀攀 挀漀洀攀渀琀愀爀椀漀猀 搀攀 氀愀 氀椀猀琀愀 礀 栀愀稀 挀氀椀挀 攀渀 ✀䌀愀爀最愀爀 瀀愀爀琀椀搀愀✀⸀∀ഀഀ
"[english]GameUI_LoadCommentaryHelp"	"Select a commentary track in the list below, then click 'Load game'."਍∀䜀愀洀攀唀䤀开一漀䌀漀洀洀攀渀琀愀爀礀䤀琀攀洀猀吀漀䐀椀猀瀀氀愀礀∀ऀ∀一漀 栀愀礀 瀀椀猀琀愀猀 搀攀 挀漀洀攀渀琀愀爀椀漀猀 搀椀猀瀀漀渀椀戀氀攀猀⸀∀ഀഀ
"[english]GameUI_NoCommentaryItemsToDisplay"	"No commentary tracks available."਍∀䜀愀洀攀唀䤀开䌀漀洀洀攀渀琀愀爀礀唀渀氀漀挀欀∀ऀ∀䌀漀洀瀀氀攀琀愀 甀渀 挀愀瀀琀甀氀漀 瀀愀爀愀 搀攀猀戀氀漀焀甀攀愀爀 猀甀 挀漀洀攀渀琀愀爀椀漀⸀∀ഀഀ
"[english]GameUI_CommentaryUnlock"	"Complete a chapter to unlock its commentary."਍∀䜀愀洀攀唀䤀开䄀开䈀唀吀吀伀一∀ऀ∀䈀漀琀渀 䄀∀ഀഀ
"[english]GameUI_A_BUTTON"	"A Button"਍∀䜀愀洀攀唀䤀开䈀开䈀唀吀吀伀一∀ऀ∀䈀漀琀渀 䈀∀ഀഀ
"[english]GameUI_B_BUTTON"	"B Button"਍∀䜀愀洀攀唀䤀开堀开䈀唀吀吀伀一∀ऀ∀䈀漀琀渀 堀∀ഀഀ
"[english]GameUI_X_BUTTON"	"X Button"਍∀䜀愀洀攀唀䤀开夀开䈀唀吀吀伀一∀ऀ∀䈀漀琀渀 夀∀ഀഀ
"[english]GameUI_Y_BUTTON"	"Y Button"਍∀䜀愀洀攀唀䤀开䰀开吀刀䤀䜀䜀䔀刀∀ऀ∀䜀愀琀椀氀氀漀 椀稀焀甀椀攀爀搀漀∀ഀഀ
"[english]GameUI_L_TRIGGER"	"Left Trigger"਍∀䜀愀洀攀唀䤀开刀开吀刀䤀䜀䜀䔀刀∀ऀ∀䜀愀琀椀氀氀漀 搀攀爀攀挀栀漀∀ഀഀ
"[english]GameUI_R_TRIGGER"	"Right Trigger"਍∀䜀愀洀攀唀䤀开䰀开匀䠀伀唀䰀䐀䔀刀∀ऀ∀䈀漀琀渀 猀甀瀀攀爀椀漀爀 椀稀焀甀椀攀爀搀漀∀ഀഀ
"[english]GameUI_L_SHOULDER"	"Left Shoulder"਍∀䜀愀洀攀唀䤀开刀开匀䠀伀唀䰀䐀䔀刀∀ऀ∀䈀漀琀渀 猀甀瀀攀爀椀漀爀 搀攀爀攀挀栀漀∀ഀഀ
"[english]GameUI_R_SHOULDER"	"Right Shoulder"਍∀䜀愀洀攀唀䤀开䤀挀漀渀猀开唀倀∀ऀ∀唀∀ഀഀ
"[english]GameUI_Icons_UP"	"U"਍∀䜀愀洀攀唀䤀开䤀挀漀渀猀开䐀伀圀一∀ऀ∀䐀∀ഀഀ
"[english]GameUI_Icons_DOWN"	"D"਍∀䜀愀洀攀唀䤀开䤀挀漀渀猀开䰀䔀䘀吀∀ऀ∀䰀∀ഀഀ
"[english]GameUI_Icons_LEFT"	"L"਍∀䜀愀洀攀唀䤀开䤀挀漀渀猀开刀䤀䜀䠀吀∀ऀ∀刀∀ഀഀ
"[english]GameUI_Icons_RIGHT"	"R"਍∀䜀愀洀攀唀䤀开䤀挀漀渀猀开䐀倀䄀䐀∀ऀ∀䌀∀ഀഀ
"[english]GameUI_Icons_DPAD"	"C"਍∀䜀愀洀攀唀䤀开䤀挀漀渀猀开匀吀䄀刀吀∀ऀ∀㔀∀ഀഀ
"[english]GameUI_Icons_START"	"5"਍∀䜀愀洀攀唀䤀开䤀挀漀渀猀开匀吀䤀䌀䬀㄀∀ऀ∀㘀∀ഀഀ
"[english]GameUI_Icons_STICK1"	"6"਍∀䜀愀洀攀唀䤀开䤀挀漀渀猀开匀吀䤀䌀䬀㈀∀ऀ∀㜀∀ഀഀ
"[english]GameUI_Icons_STICK2"	"7"਍∀䜀愀洀攀唀䤀开䤀挀漀渀猀开匀㄀开唀倀∀ऀ∀㘀∀ഀഀ
"[english]GameUI_Icons_S1_UP"	"6"਍∀䜀愀洀攀唀䤀开䤀挀漀渀猀开匀㈀开唀倀∀ऀ∀㜀∀ഀഀ
"[english]GameUI_Icons_S2_UP"	"7"਍∀䜀愀洀攀唀䤀开䤀挀漀渀猀开䰀匀吀䤀䌀䬀∀ऀ∀㘀∀ഀഀ
"[english]GameUI_Icons_LSTICK"	"6"਍∀䜀愀洀攀唀䤀开䤀挀漀渀猀开刀匀吀䤀䌀䬀∀ऀ∀㜀∀ഀഀ
"[english]GameUI_Icons_RSTICK"	"7"਍∀䜀愀洀攀唀䤀开䤀挀漀渀猀开䄀开䈀唀吀吀伀一∀ऀ∀䄀∀ഀഀ
"[english]GameUI_Icons_A_BUTTON"	"A"਍∀䜀愀洀攀唀䤀开䤀挀漀渀猀开䈀开䈀唀吀吀伀一∀ऀ∀䈀∀ഀഀ
"[english]GameUI_Icons_B_BUTTON"	"B"਍∀䜀愀洀攀唀䤀开䤀挀漀渀猀开堀开䈀唀吀吀伀一∀ऀ∀堀∀ഀഀ
"[english]GameUI_Icons_X_BUTTON"	"X"਍∀䜀愀洀攀唀䤀开䤀挀漀渀猀开夀开䈀唀吀吀伀一∀ऀ∀夀∀ഀഀ
"[english]GameUI_Icons_Y_BUTTON"	"Y"਍∀䜀愀洀攀唀䤀开䤀挀漀渀猀开䰀开匀䠀伀唀䰀䐀䔀刀∀ऀ∀㈀∀ഀഀ
"[english]GameUI_Icons_L_SHOULDER"	"2"਍∀䜀愀洀攀唀䤀开䤀挀漀渀猀开刀开匀䠀伀唀䰀䐀䔀刀∀ऀ∀㌀∀ഀഀ
"[english]GameUI_Icons_R_SHOULDER"	"3"਍∀䜀愀洀攀唀䤀开䤀挀漀渀猀开䰀开吀刀䤀䜀䜀䔀刀∀ऀ∀　∀ഀഀ
"[english]GameUI_Icons_L_TRIGGER"	"0"਍∀䜀愀洀攀唀䤀开䤀挀漀渀猀开刀开吀刀䤀䜀䜀䔀刀∀ऀ∀㄀∀ഀഀ
"[english]GameUI_Icons_R_TRIGGER"	"1"਍∀䜀愀洀攀唀䤀开䤀挀漀渀猀开䰀䔀䘀吀䌀唀刀匀伀刀∀ऀ∀㠀∀ഀഀ
"[english]GameUI_Icons_LEFTCURSOR"	"8"਍∀䜀愀洀攀唀䤀开䤀挀漀渀猀开刀䤀䜀䠀吀䌀唀刀匀伀刀∀ऀ∀㤀∀ഀഀ
"[english]GameUI_Icons_RIGHTCURSOR"	"9"਍∀䜀愀洀攀唀䤀开䤀挀漀渀猀开唀倀䌀唀刀匀伀刀∀ऀ∀㰀∀ഀഀ
"[english]GameUI_Icons_UPCURSOR"	"<"਍∀䜀愀洀攀唀䤀开䤀挀漀渀猀开䐀伀圀一䌀唀刀匀伀刀∀ऀ∀㸀∀ഀഀ
"[english]GameUI_Icons_DOWNCURSOR"	">"਍∀䜀愀洀攀唀䤀开䤀挀漀渀猀开一伀一䔀∀ऀ∀㰀 猀椀渀 愀猀椀最渀愀爀 㸀∀ഀഀ
"[english]GameUI_Icons_NONE"	"< not assigned >"਍∀䜀愀洀攀唀䤀开䬀攀礀一愀洀攀猀开唀倀∀ऀ∀洀愀渀搀漀 䐀 愀爀爀椀戀愀∀ഀഀ
"[english]GameUI_KeyNames_UP"	"D-pad up"਍∀䜀愀洀攀唀䤀开䬀攀礀一愀洀攀猀开䐀伀圀一∀ऀ∀洀愀渀搀漀 䐀 愀戀愀樀漀∀ഀഀ
"[english]GameUI_KeyNames_DOWN"	"D-pad down"਍∀䜀愀洀攀唀䤀开䬀攀礀一愀洀攀猀开䰀䔀䘀吀∀ऀ∀洀愀渀搀漀 䐀 椀稀焀甀椀攀爀搀愀∀ഀഀ
"[english]GameUI_KeyNames_LEFT"	"D-pad left"਍∀䜀愀洀攀唀䤀开䬀攀礀一愀洀攀猀开刀䤀䜀䠀吀∀ऀ∀洀愀渀搀漀 䐀 搀攀爀攀挀栀愀∀ഀഀ
"[english]GameUI_KeyNames_RIGHT"	"D-pad right"਍∀䜀愀洀攀唀䤀开䬀攀礀一愀洀攀猀开匀吀䄀刀吀∀ऀ∀戀漀琀渀 匀吀䄀刀吀∀ഀഀ
"[english]GameUI_KeyNames_START"	"START button"਍∀䜀愀洀攀唀䤀开䬀攀礀一愀洀攀猀开䈀䄀䌀䬀∀ऀ∀戀漀琀渀 䈀䄀䌀䬀∀ഀഀ
"[english]GameUI_KeyNames_BACK"	"BACK button"਍∀䜀愀洀攀唀䤀开䬀攀礀一愀洀攀猀开匀吀䤀䌀䬀㄀∀ऀ∀戀漀琀渀 搀攀 猀琀椀挀欀 椀稀焀甀椀攀爀搀漀∀ഀഀ
"[english]GameUI_KeyNames_STICK1"	"left stick button"਍∀䜀愀洀攀唀䤀开䬀攀礀一愀洀攀猀开匀吀䤀䌀䬀㈀∀ऀ∀戀漀琀渀 搀攀 猀琀椀挀欀 搀攀爀攀挀栀漀∀ഀഀ
"[english]GameUI_KeyNames_STICK2"	"right stick button"਍∀䜀愀洀攀唀䤀开䬀攀礀一愀洀攀猀开匀㄀开唀倀∀ऀ∀猀琀椀挀欀 椀稀焀甀椀攀爀搀漀∀ഀഀ
"[english]GameUI_KeyNames_S1_UP"	"left stick"਍∀䜀愀洀攀唀䤀开䬀攀礀一愀洀攀猀开匀㈀开唀倀∀ऀ∀猀琀椀挀欀 搀攀爀攀挀栀漀∀ഀഀ
"[english]GameUI_KeyNames_S2_UP"	"right stick"਍∀䜀愀洀攀唀䤀开䬀攀礀一愀洀攀猀开䰀匀吀䤀䌀䬀∀ऀ∀猀琀椀挀欀 椀稀焀甀椀攀爀搀漀∀ഀഀ
"[english]GameUI_KeyNames_LSTICK"	"left stick"਍∀䜀愀洀攀唀䤀开䬀攀礀一愀洀攀猀开刀匀吀䤀䌀䬀∀ऀ∀猀琀椀挀欀 搀攀爀攀挀栀漀∀ഀഀ
"[english]GameUI_KeyNames_RSTICK"	"right stick"਍∀䜀愀洀攀唀䤀开䬀攀礀一愀洀攀猀开䄀开䈀唀吀吀伀一∀ऀ∀戀漀琀渀 䄀∀ഀഀ
"[english]GameUI_KeyNames_A_BUTTON"	"A button"਍∀䜀愀洀攀唀䤀开䬀攀礀一愀洀攀猀开䈀开䈀唀吀吀伀一∀ऀ∀戀漀琀渀 䈀∀ഀഀ
"[english]GameUI_KeyNames_B_BUTTON"	"B button"਍∀䜀愀洀攀唀䤀开䬀攀礀一愀洀攀猀开堀开䈀唀吀吀伀一∀ऀ∀戀漀琀渀 堀∀ഀഀ
"[english]GameUI_KeyNames_X_BUTTON"	"X button"਍∀䜀愀洀攀唀䤀开䬀攀礀一愀洀攀猀开夀开䈀唀吀吀伀一∀ऀ∀戀漀琀渀 夀∀ഀഀ
"[english]GameUI_KeyNames_Y_BUTTON"	"Y button"਍∀䜀愀洀攀唀䤀开䬀攀礀一愀洀攀猀开䰀开匀䠀伀唀䰀䐀䔀刀∀ऀ∀戀漀琀渀 猀甀瀀攀爀椀漀爀 昀爀漀渀琀愀氀 椀稀焀甀椀攀爀搀漀∀ഀഀ
"[english]GameUI_KeyNames_L_SHOULDER"	"left bumper"਍∀䜀愀洀攀唀䤀开䬀攀礀一愀洀攀猀开刀开匀䠀伀唀䰀䐀䔀刀∀ऀ∀戀漀琀渀 猀甀瀀攀爀椀漀爀 昀爀漀渀琀愀氀 搀攀爀攀挀栀漀∀ഀഀ
"[english]GameUI_KeyNames_R_SHOULDER"	"right bumper"਍∀䜀愀洀攀唀䤀开䬀攀礀一愀洀攀猀开䰀开吀刀䤀䜀䜀䔀刀∀ऀ∀最愀琀椀氀氀漀 椀稀焀甀椀攀爀搀漀∀ഀഀ
"[english]GameUI_KeyNames_L_TRIGGER"	"left trigger"਍∀䜀愀洀攀唀䤀开䬀攀礀一愀洀攀猀开刀开吀刀䤀䜀䜀䔀刀∀ऀ∀最愀琀椀氀氀漀 搀攀爀攀挀栀漀∀ഀഀ
"[english]GameUI_KeyNames_R_TRIGGER"	"right trigger"਍∀䜀愀洀攀唀䤀开䜀愀洀攀∀ऀ∀倀䄀刀吀䤀䐀䄀∀ऀ嬀␀堀㌀㘀　崀ഀഀ
"[english]GameUI_Game"	"GAME"਍∀䜀愀洀攀唀䤀开䌀漀渀琀爀漀氀氀攀爀∀ऀ∀䌀伀一吀刀伀䰀∀ഀഀ
"[english]GameUI_Controller"	"CONTROLLER"਍∀䜀愀洀攀唀䤀开䈀甀琀琀漀渀猀∀ऀ∀䈀伀吀伀一䔀匀∀ഀഀ
"[english]GameUI_Buttons"	"BUTTONS"਍∀䜀愀洀攀唀䤀开刀攀猀琀漀爀攀䐀攀昀愀甀氀琀猀∀ऀ∀刀䔀匀吀䄀唀刀䄀刀 嘀䄀䰀伀刀䔀匀 倀刀䔀䐀䔀吀䔀刀䴀䤀一䄀䐀伀匀∀ഀഀ
"[english]GameUI_RestoreDefaults"	"RESTORE DEFAULTS"਍∀䜀愀洀攀唀䤀开䄀挀挀攀瀀琀∀ऀ∀䄀挀攀瀀琀愀爀∀ഀഀ
"[english]GameUI_Accept"	"Accept"਍∀䜀愀洀攀唀䤀开匀攀氀攀挀琀∀ऀ∀匀攀氀攀挀挀椀漀渀愀爀∀ഀഀ
"[english]GameUI_Select"	"Select"਍∀䜀愀洀攀唀䤀开刀攀昀爀攀猀栀∀ऀ∀䄀挀琀甀愀氀椀稀愀爀∀ഀഀ
"[english]GameUI_Refresh"	"Refresh"਍∀䜀愀洀攀唀䤀开匀漀爀琀∀ऀ∀伀爀搀攀渀愀爀∀ഀഀ
"[english]GameUI_Sort"	"Sort"਍∀䜀愀洀攀唀䤀开䔀砀椀琀䰀漀戀戀礀∀ऀ∀匀愀氀椀爀∀ഀഀ
"[english]GameUI_ExitLobby"	"Exit"਍∀䜀愀洀攀唀䤀开䌀栀愀渀最攀吀攀愀洀∀ऀ∀䌀愀洀戀椀愀爀 搀攀 攀焀甀椀瀀漀∀ഀഀ
"[english]GameUI_ChangeTeam"	"Change Team"਍∀䜀愀洀攀唀䤀开䌀栀愀渀最攀䜀愀洀攀匀攀琀琀椀渀最猀∀ऀ∀䌀愀洀戀椀愀爀 挀漀渀昀椀最甀爀愀挀椀渀∀ഀഀ
"[english]GameUI_ChangeGameSettings"	"Change Settings"਍∀䜀愀洀攀唀䤀开倀氀愀礀攀爀刀攀瘀椀攀眀∀ऀ∀䤀渀昀漀爀洀攀 搀攀 樀甀最愀搀漀爀∀ഀഀ
"[english]GameUI_PlayerReview"	"Player Review"਍∀䜀愀洀攀唀䤀开匀琀愀爀琀䜀愀洀攀∀ऀ∀䤀渀椀挀椀愀爀 瀀愀爀琀椀搀愀∀ഀഀ
"[english]GameUI_StartGame"	"Start Game"਍∀䜀愀洀攀唀䤀开匀琀漀瀀䌀漀甀渀琀搀漀眀渀∀ऀ∀䌀愀渀挀攀氀愀爀 挀甀攀渀琀愀 愀琀爀猀∀ഀഀ
"[english]GameUI_StopCountdown"	"Cancel Countdown"਍∀䜀愀洀攀唀䤀开䌀漀渀猀漀氀攀开䘀椀氀攀䌀漀爀爀甀瀀琀∀ऀ∀䔀氀 攀氀 搀椀猀瀀漀猀椀琀椀瘀漀 搀攀 愀氀洀愀挀攀渀愀洀椀攀渀琀漀 猀攀氀攀挀挀椀漀渀愀搀漀 挀漀渀琀椀攀渀攀 甀渀 愀爀挀栀椀瘀漀 挀漀爀爀甀瀀琀漀 漀 焀甀攀 渀漀 瀀甀攀搀攀 愀戀爀椀爀猀攀⸀  匀攀氀攀挀挀椀漀渀愀 漀琀爀漀 搀椀猀瀀漀猀椀琀椀瘀漀 搀攀 愀氀洀愀挀攀渀愀洀椀攀渀琀漀 漀 戀漀爀爀愀 攀氀 愀爀挀栀椀瘀漀 搀愀愀搀漀⸀∀ഀഀ
"[english]GameUI_Console_FileCorrupt"	"The selected storage device contains a file that is corrupted or not able to be opened.  Please choose another storage device or delete the corrupted file."਍∀䜀愀洀攀唀䤀开䄀瀀瀀䌀栀漀漀猀攀爀开匀攀氀攀挀琀䜀愀洀攀∀ऀ∀匀䔀䰀䔀䌀䌀䤀伀一䄀 倀䄀刀吀䤀䐀䄀㨀∀ഀഀ
"[english]GameUI_AppChooser_SelectGame"	"SELECT GAME:"਍∀䜀愀洀攀唀䤀开夀攀猀∀ऀ∀匀∀ഀഀ
"[english]GameUI_Yes"	"Yes"਍∀䜀愀洀攀唀䤀开一漀∀ऀ∀一漀∀ഀഀ
"[english]GameUI_No"	"No"਍∀䜀愀洀攀唀䤀开䌀漀渀猀漀氀攀开儀甀椀琀圀愀爀渀椀渀最∀ऀ∀뼀匀攀最甀爀漀 焀甀攀 焀甀椀攀爀攀猀 愀戀愀渀搀漀渀愀爀㼀尀渀䰀漀猀 愀瘀愀渀挀攀猀 焀甀攀 渀漀 栀愀礀愀猀 最甀愀爀搀愀搀漀 猀攀 瀀攀爀搀攀爀渀⸀∀ഀഀ
"[english]GameUI_Console_QuitWarning"	"Are you sure you want to quit?\nAll unsaved progress will be lost."਍∀䜀愀洀攀唀䤀开䌀漀渀猀漀氀攀开匀琀漀爀愀最攀刀攀洀漀瘀攀搀吀椀琀氀攀∀ऀ∀䐀椀猀瀀漀猀椀琀椀瘀漀 搀攀 愀氀洀愀挀攀渀愀洀椀攀渀琀漀 攀砀琀爀愀搀漀∀ഀഀ
"[english]GameUI_Console_StorageRemovedTitle"	"Storage Device Removed"਍∀䜀愀洀攀唀䤀开䌀漀渀猀漀氀攀开匀琀漀爀愀最攀刀攀洀漀瘀攀搀䈀漀搀礀∀ऀ∀一漀 瀀漀搀爀猀 最甀愀爀搀愀爀 琀甀猀 愀瘀愀渀挀攀猀 猀椀渀 甀渀 搀椀猀瀀漀猀椀琀椀瘀漀 搀攀 愀氀洀愀挀攀渀愀洀椀攀渀琀漀⸀ 뼀儀甀椀攀爀攀猀 猀攀氀攀挀挀椀漀渀愀爀 漀琀爀漀 搀椀猀瀀漀猀椀琀椀瘀漀 搀攀 愀氀洀愀挀攀渀愀洀椀攀渀琀漀㼀∀ഀഀ
"[english]GameUI_Console_StorageRemovedBody"	"You will not be able to save your progress without a storage device. Would you like to select another storage device?"਍∀䜀愀洀攀唀䤀开䌀漀渀猀漀氀攀开匀琀漀爀愀最攀一攀攀搀攀搀䈀漀搀礀∀ऀ∀一漀 瀀漀搀爀猀 猀攀最甀椀爀 樀甀最愀渀搀漀 猀椀渀 甀渀 搀椀猀瀀漀猀椀琀椀瘀漀 搀攀 愀氀洀愀挀攀渀愀洀椀攀渀琀漀⸀ 뼀儀甀椀攀爀攀猀 猀攀氀攀挀挀椀漀渀愀爀 漀琀爀漀 搀椀猀瀀漀猀椀琀椀瘀漀 搀攀 愀氀洀愀挀攀渀愀洀椀攀渀琀漀㼀∀ഀഀ
"[english]GameUI_Console_StorageNeededBody"	"You will not be able to continue playing without a storage device. Would you like to select another storage device?"਍∀䜀愀洀攀唀䤀开䌀漀渀猀漀氀攀开匀琀漀爀愀最攀䌀栀愀渀最攀∀ऀ∀䌀愀洀戀椀愀爀 攀氀 搀椀猀瀀漀猀椀琀椀瘀漀 搀攀 愀氀洀愀挀攀渀愀洀椀攀渀琀漀∀ഀഀ
"[english]GameUI_Console_StorageChange"	"Change Storage Device"਍∀䜀愀洀攀唀䤀开䌀漀渀猀漀氀攀开匀琀漀爀愀最攀吀漀漀䘀甀氀氀吀椀琀氀攀∀ऀ∀䐀椀猀瀀漀猀椀琀椀瘀漀 搀攀 愀氀洀愀挀攀渀愀洀椀攀渀琀漀 氀氀攀渀漀∀ഀഀ
"[english]GameUI_Console_StorageTooFullTitle"	"Storage Device Full"਍∀䜀愀洀攀唀䤀开䌀漀渀猀漀氀攀开匀琀漀爀愀最攀吀漀漀䘀甀氀氀䈀漀搀礀∀ऀ∀䔀氀 搀椀猀瀀漀猀椀琀椀瘀漀 搀攀 愀氀洀愀挀攀渀愀洀椀攀渀琀漀 渀漀 琀椀攀渀攀 猀甀昀椀挀椀攀渀琀攀 攀猀瀀愀挀椀漀 瀀愀爀愀 挀爀攀愀爀 渀甀攀瘀愀猀 瀀愀爀琀椀搀愀猀 最甀愀爀搀愀搀愀猀⸀ 뼀儀甀椀攀爀攀猀 猀攀氀攀挀挀椀漀渀愀爀 漀琀爀漀 搀椀猀瀀漀猀椀琀椀瘀漀 搀攀 愀氀洀愀挀攀渀愀洀椀攀渀琀漀㼀∀ഀഀ
"[english]GameUI_Console_StorageTooFullBody"	"The selected storage device does not have enough space to create new saved games. Would you like to select another storage device?"਍∀䜀愀洀攀唀䤀开䌀漀渀猀漀氀攀开一漀匀琀漀爀愀最攀䐀攀瘀椀挀攀匀攀氀攀挀琀攀搀吀椀琀氀攀∀ऀ∀一漀 猀攀 栀愀 猀攀氀攀挀挀椀漀渀愀搀漀 甀渀 搀椀猀瀀漀猀椀琀椀瘀漀 搀攀 愀氀洀愀挀攀渀愀洀椀攀渀琀漀∀ഀഀ
"[english]GameUI_Console_NoStorageDeviceSelectedTitle"	"No Storage Device Selected"਍∀䜀愀洀攀唀䤀开䌀漀渀猀漀氀攀开一漀匀琀漀爀愀最攀䐀攀瘀椀挀攀匀攀氀攀挀琀攀搀䈀漀搀礀∀ऀ∀뼀儀甀椀攀爀攀猀 猀攀氀攀挀挀椀漀渀愀爀 甀渀 搀椀猀瀀漀猀椀琀椀瘀漀 搀攀 愀氀洀愀挀攀渀愀洀椀攀渀琀漀㼀尀渀尀渀匀椀 攀氀椀最攀猀 ✀一漀✀ 瀀漀搀爀猀 樀甀最愀爀Ⰰ 瀀攀爀漀 渀漀 瀀漀搀爀猀 最甀愀爀搀愀爀 琀甀猀 愀瘀愀渀挀攀猀⸀∀ഀഀ
"[english]GameUI_Console_NoStorageDeviceSelectedBody"	"Would you like to select a storage device?\n\nChoosing 'No' will let you play the game, but you will not be able to save your progress."਍∀䜀愀洀攀唀䤀开䌀漀渀猀漀氀攀开一漀唀猀攀爀倀爀漀昀椀氀攀匀攀氀攀挀琀攀搀吀椀琀氀攀∀ऀ∀一漀 猀攀 栀愀 猀攀氀攀挀挀椀漀渀愀搀漀 甀渀 瀀攀爀昀椀氀 搀攀 樀甀最愀搀漀爀∀ഀഀ
"[english]GameUI_Console_NoUserProfileSelectedTitle"	"No Gamer Profile Selected"਍∀䜀愀洀攀唀䤀开䌀漀渀猀漀氀攀开一漀唀猀攀爀倀爀漀昀椀氀攀匀攀氀攀挀琀攀搀䈀漀搀礀∀ऀ∀뼀儀甀椀攀爀攀猀 猀攀氀攀挀挀椀漀渀愀爀 甀渀 瀀攀爀昀椀氀 搀攀 樀甀最愀搀漀爀㼀尀渀匀椀 攀氀椀最攀猀 ✀一漀✀ 瀀漀搀爀猀 樀甀最愀爀Ⰰ 瀀攀爀漀 渀漀 瀀漀搀爀猀 最甀愀爀搀愀爀 琀甀猀 愀瘀愀渀挀攀猀⸀∀ഀഀ
"[english]GameUI_Console_NoUserProfileSelectedBody"	"Would you like to select a gamer profile?\nChoosing 'No' will let you play the game, but you will not be able to save your progress."਍∀䜀愀洀攀唀䤀开䌀漀渀猀漀氀攀开唀猀攀爀倀爀漀昀椀氀攀刀攀焀甀椀爀攀搀䈀漀搀礀∀ऀ∀倀愀爀愀 爀攀愀氀椀稀愀爀 攀猀琀愀 愀挀挀椀渀Ⰰ 搀攀戀攀猀 椀渀椀挀椀愀爀 猀攀猀椀渀⸀尀渀뼀儀甀椀攀爀攀猀 猀攀氀攀挀挀椀漀渀愀爀 甀渀 瀀攀爀昀椀氀 搀攀 樀甀最愀搀漀爀㼀∀ഀഀ
"[english]GameUI_Console_UserProfileRequiredBody"	"This action requires that you be signed in.\nWould you like to select a gamer profile?"਍∀䜀愀洀攀唀䤀开䌀漀渀猀漀氀攀开匀琀漀爀愀最攀䐀攀瘀椀挀攀刀攀焀甀椀爀攀搀䈀漀搀礀∀ऀ∀倀愀爀愀 爀攀愀氀椀稀愀爀 攀猀琀愀 愀挀挀椀渀Ⰰ 搀攀戀攀猀 猀攀氀攀挀挀椀漀渀愀爀 甀渀 搀椀猀瀀漀猀椀琀椀瘀漀 搀攀 愀氀洀愀挀攀渀愀洀椀攀渀琀漀⸀尀渀尀渀뼀儀甀椀攀爀攀猀 猀攀氀攀挀挀椀漀渀愀爀 甀渀 搀椀猀瀀漀猀椀琀椀瘀漀 搀攀 愀氀洀愀挀攀渀愀洀椀攀渀琀漀㼀∀ഀഀ
"[english]GameUI_Console_StorageDeviceRequiredBody"	"This action requires that you select a storage device.\n\nWould you like to select a storage device?"਍∀䜀愀洀攀唀䤀开䄀挀栀椀攀瘀攀洀攀渀琀开䄀眀愀爀搀攀搀∀ऀ∀䰀漀最爀漀 搀攀猀戀氀漀焀甀攀愀搀漀∀ഀഀ
"[english]GameUI_Achievement_Awarded"	"Achievement Unlocked"਍∀䜀愀洀攀唀䤀开䄀挀栀椀攀瘀攀洀攀渀琀开倀爀漀最爀攀猀猀∀ऀ∀䄀瘀愀渀挀攀 攀渀 氀漀猀 氀漀最爀漀猀∀ഀഀ
"[english]GameUI_Achievement_Progress"	"Achievement Progress"਍∀䜀愀洀攀唀䤀开䄀挀栀椀攀瘀攀洀攀渀琀开倀爀漀最爀攀猀猀开䘀洀琀∀ऀ∀─猀㄀ ⠀─猀㈀⼀─猀㌀⤀∀ഀഀ
"[english]GameUI_Achievement_Progress_Fmt"	"%s1 (%s2/%s3)"਍∀䜀愀洀攀唀䤀开䄀挀栀椀攀瘀攀洀攀渀琀开䰀漀挀欀攀搀∀ऀ∀䈀氀漀焀甀攀愀搀漀∀ഀഀ
"[english]GameUI_Achievement_Locked"	"Locked"਍∀䜀愀洀攀唀䤀开䄀挀栀椀攀瘀攀洀攀渀琀开唀渀氀漀挀欀攀搀∀ऀ∀䐀攀猀戀氀漀焀甀攀愀搀漀∀ഀഀ
"[english]GameUI_Achievement_Unlocked"	"Unlocked"਍∀䜀愀洀攀唀䤀开䄀挀栀椀攀瘀攀洀攀渀琀猀开吀椀琀氀攀∀ऀ∀䴀椀猀 氀漀最爀漀猀∀ഀഀ
"[english]GameUI_Achievements_Title"	"My Achievements"਍∀䜀愀洀攀唀䤀开䄀挀栀椀攀瘀攀洀攀渀琀猀开匀琀攀愀洀刀攀焀甀椀爀攀搀开吀椀琀氀攀∀ऀ∀䔀猀 渀攀挀攀猀愀爀椀漀 攀猀琀愀爀 挀漀渀攀挀琀愀搀漀 愀 匀琀攀愀洀∀ഀഀ
"[english]GameUI_Achievements_SteamRequired_Title"	"Steam Login Required"਍∀䜀愀洀攀唀䤀开䄀挀栀椀攀瘀攀洀攀渀琀猀开匀琀攀愀洀刀攀焀甀椀爀攀搀开䴀攀猀猀愀最攀∀ऀ∀䐀攀戀攀猀 挀漀渀攀挀琀愀爀琀攀 愀 匀琀攀愀洀 瀀愀爀愀 搀攀猀戀氀漀焀甀攀愀爀 漀 瘀攀爀 氀漀猀 䰀漀最爀漀猀⸀∀ഀഀ
"[english]GameUI_Achievements_SteamRequired_Message"	"You must be logged in to Steam to unlock or view Achievements."਍∀䜀愀洀攀唀䤀开䄀挀栀椀攀瘀攀洀攀渀琀猀开䔀渀琀攀爀䜀愀洀攀吀漀匀攀攀倀爀漀最爀攀猀猀∀ऀ∀唀渀椀爀猀攀 愀 氀愀 瀀愀爀琀椀搀愀 瀀愀爀愀 瘀攀爀 氀漀猀 愀瘀愀渀挀攀猀∀ഀഀ
"[english]GameUI_Achievements_EnterGameToSeeProgress"	"Enter game to see progress"਍∀䜀愀洀攀唀䤀开䄀挀栀椀攀瘀攀洀攀渀琀开倀漀椀渀琀猀∀ऀ∀─猀㄀䜀∀ഀഀ
"[english]GameUI_Achievement_Points"	"%s1G"਍∀䜀愀洀攀唀䤀开䄀挀栀椀攀瘀攀洀攀渀琀开䴀攀渀甀开刀愀渀最攀∀ऀ∀─猀㄀ 搀攀 ─猀㈀∀ഀഀ
"[english]GameUI_Achievement_Menu_Range"	"%s1 of %s2"਍∀䜀愀洀攀唀䤀开䄀挀栀椀攀瘀攀洀攀渀琀猀开䔀愀爀渀攀搀∀ऀ∀䰀漀最爀漀猀 琀漀琀愀氀攀猀 挀漀渀猀攀最甀椀搀漀猀∀ഀഀ
"[english]GameUI_Achievements_Earned"	"Total Achievements Earned"਍∀䜀愀洀攀唀䤀开䄀挀栀椀攀瘀攀洀攀渀琀开䠀椀搀攀开䄀挀栀椀攀瘀攀搀∀ऀ∀伀挀甀氀琀愀爀 挀漀洀瀀氀攀琀愀搀漀猀∀ഀഀ
"[english]GameUI_Achievement_Hide_Achieved"	"Hide Achieved"਍∀䜀愀洀攀唀䤀开䄀挀栀椀攀瘀攀洀攀渀琀开䠀椀搀攀开唀渀愀挀栀椀攀瘀攀搀∀ऀ∀伀挀甀氀琀愀爀 倀攀渀搀椀攀渀琀攀猀∀ഀഀ
"[english]GameUI_Achievement_Hide_Unachieved"	"Hide Unachieved"਍∀䜀愀洀攀唀䤀开䄀挀栀椀攀瘀攀洀攀渀琀开匀栀漀眀开䠀唀䐀∀ऀ∀䴀漀猀琀爀愀爀 攀渀 䠀唀䐀∀ഀഀ
"[english]GameUI_Achievement_Show_HUD"	"Show on HUD"਍∀䜀愀洀攀唀䤀开䌀漀渀猀漀氀攀开唀猀攀爀匀攀琀琀椀渀最猀∀ऀ∀䌀漀渀昀椀最甀爀愀挀椀渀 瀀攀爀猀漀渀愀氀椀稀愀搀愀∀ഀഀ
"[english]GameUI_Console_UserSettings"	"User Settings"਍∀䜀愀洀攀唀䤀开䌀漀渀猀漀氀攀开䔀瀀㄀开匀愀瘀攀猀∀ऀ∀倀愀爀琀椀搀愀猀 最甀愀爀搀愀搀愀猀 搀攀 䠀䰀㈀㨀 䔀瀀椀猀漀搀椀漀 ㄀∀ഀഀ
"[english]GameUI_Console_Ep1_Saves"	"HL2: Episode One Saves"਍∀䜀愀洀攀唀䤀开䌀漀渀猀漀氀攀开䔀瀀㈀开匀愀瘀攀猀∀ऀ∀倀愀爀琀椀搀愀猀 最甀愀爀搀愀搀愀猀 搀攀 䠀䰀㈀㨀 䔀瀀椀猀漀搀椀漀 ㈀∀ഀഀ
"[english]GameUI_Console_Ep2_Saves"	"HL2: Episode Two Saves"਍∀䜀愀洀攀唀䤀开䌀漀渀猀漀氀攀开倀漀爀琀愀氀开匀愀瘀攀猀∀ऀ∀倀愀爀琀椀搀愀猀 最甀愀爀搀愀搀愀猀 搀攀 倀漀爀琀愀氀∀ഀഀ
"[english]GameUI_Console_Portal_Saves"	"Portal Saves"਍∀䜀愀洀攀唀䤀开䌀漀渀猀漀氀攀开吀䘀㈀开匀愀瘀攀猀∀ऀ∀倀愀爀琀椀搀愀猀 最甀愀爀搀愀搀愀猀 搀攀 吀攀愀洀 䘀漀爀琀爀攀猀猀 ㈀∀ഀഀ
"[english]GameUI_Console_TF2_Saves"	"Team Fortress 2 Saves"਍∀䜀愀洀攀唀䤀开䌀漀渀猀漀氀攀开䠀䰀㈀开匀愀瘀攀猀∀ऀ∀倀愀爀琀椀搀愀猀 最甀愀爀搀愀搀愀猀 搀攀 䠀愀氀昀ⴀ䰀椀昀攀 ㈀∀ഀഀ
"[english]GameUI_Console_HL2_Saves"	"Half-Life 2 Saves"਍∀䜀愀洀攀唀䤀开䰀漀愀搀䘀愀椀氀攀搀∀ऀ∀䘀愀氀氀漀 愀氀 挀愀爀最愀爀∀ഀഀ
"[english]GameUI_LoadFailed"	"Load Failed"਍∀䜀愀洀攀唀䤀开䰀漀愀搀䘀愀椀氀攀搀开䐀攀猀挀爀椀瀀琀椀漀渀∀ऀ∀匀攀 栀愀 攀砀琀爀愀搀漀 甀渀 搀椀猀瀀漀猀椀琀椀瘀漀 搀攀 愀氀洀愀挀攀渀愀洀椀攀渀琀漀 洀椀攀渀琀爀愀猀 猀攀 挀愀爀最愀戀愀Ⰰ 漀 攀氀 愀爀挀栀椀瘀漀 攀猀琀愀戀愀 搀愀愀搀漀⸀尀渀尀渀一漀 猀攀 栀愀 瀀漀搀椀搀漀 挀愀爀最愀爀 氀愀 瀀愀爀琀椀搀愀 最甀愀爀搀愀搀愀⸀∀ഀഀ
"[english]GameUI_LoadFailed_Description"	"A storage device was removed while loading, or a file was corrupt.\n\nUnable to load save game."਍∀䠀䰀堀开䬀䤀䰀䰀开䔀一䔀䴀䤀䔀匀开圀䤀吀䠀倀䠀夀匀䤀䌀匀开一䄀䴀䔀∀ऀ∀儀甀攀戀爀愀渀琀愀栀甀攀猀漀猀∀ഀഀ
"[english]HLX_KILL_ENEMIES_WITHPHYSICS_NAME"	"Bone Breaker"਍∀䠀䰀堀开䬀䤀䰀䰀开䔀一䔀䴀䤀䔀匀开圀䤀吀䠀倀䠀夀匀䤀䌀匀开䐀䔀匀䌀∀ऀ∀䴀愀琀愀 愀 ㌀　 攀渀攀洀椀最漀猀 琀椀爀渀搀漀氀攀猀 漀戀樀攀琀漀猀⸀∀ഀഀ
"[english]HLX_KILL_ENEMIES_WITHPHYSICS_DESC"	"Kill 30 enemies with thrown physics objects."਍∀䠀䰀堀开䬀䤀䰀䰀开䔀一䔀䴀夀开圀䤀吀䠀䠀伀倀倀䔀刀䴀䤀一䔀开一䄀䴀䔀∀ऀ∀倀氀愀渀琀愀挀椀渀 氀攀琀愀氀∀ഀഀ
"[english]HLX_KILL_ENEMY_WITHHOPPERMINE_NAME"	"Deadly Harvest"਍∀䠀䰀堀开䬀䤀䰀䰀开䔀一䔀䴀夀开圀䤀吀䠀䠀伀倀倀䔀刀䴀䤀一䔀开䐀䔀匀䌀∀ऀ∀䴀愀琀愀 愀 甀渀 攀渀攀洀椀最漀 挀漀氀漀挀愀渀搀漀 甀渀愀 洀椀渀愀 猀愀氀琀愀搀漀爀愀⸀∀ഀഀ
"[english]HLX_KILL_ENEMY_WITHHOPPERMINE_DESC"	"Kill an enemy by planting a hopper mine."਍∀䠀䰀堀开䬀䤀䰀䰀开䔀一䔀䴀䤀䔀匀开圀䤀吀䠀䴀䄀一䠀䄀䌀䬀开一䄀䴀䔀∀ऀ∀刀漀戀漀猀愀樀攀∀ഀഀ
"[english]HLX_KILL_ENEMIES_WITHMANHACK_NAME"	"Hack Attack!"਍∀䠀䰀堀开䬀䤀䰀䰀开䔀一䔀䴀䤀䔀匀开圀䤀吀䠀䴀䄀一䠀䄀䌀䬀开䐀䔀匀䌀∀ऀ∀䴀愀琀愀 愀 㔀 攀渀攀洀椀最漀猀 挀漀渀 甀渀愀 爀漀戀漀猀椀攀爀爀愀⸀∀ഀഀ
"[english]HLX_KILL_ENEMIES_WITHMANHACK_DESC"	"Kill five enemies with a Manhack."਍∀䠀䰀堀开䬀䤀䰀䰀开匀伀䰀䐀䤀䔀刀开圀䤀吀䠀䠀䤀匀䜀刀䔀一䄀䐀䔀开一䄀䴀䔀∀ऀ∀倀愀琀愀琀愀 挀愀氀椀攀渀琀攀∀ഀഀ
"[english]HLX_KILL_SOLDIER_WITHHISGRENADE_NAME"	"Hot Potat0wned"਍∀䠀䰀堀开䬀䤀䰀䰀开匀伀䰀䐀䤀䔀刀开圀䤀吀䠀䠀䤀匀䜀刀䔀一䄀䐀䔀开䐀䔀匀䌀∀ऀ∀䴀愀琀愀 愀 甀渀 猀漀氀搀愀搀漀 搀攀 氀愀 䄀氀椀愀渀稀愀 挀漀渀 猀甀 瀀爀漀瀀椀愀 最爀愀渀愀搀愀⸀∀ഀഀ
"[english]HLX_KILL_SOLDIER_WITHHISGRENADE_DESC"	"Kill a Combine soldier with his own grenade."਍∀䠀䰀堀开䬀䤀䰀䰀开䔀一䔀䴀䤀䔀匀开圀䤀吀䠀伀一䔀䔀一䔀刀䜀夀䈀䄀䰀䰀开一䄀䴀䔀∀ऀ∀䄀栀漀爀爀愀搀漀爀∀ഀഀ
"[english]HLX_KILL_ENEMIES_WITHONEENERGYBALL_NAME"	"Conservationist"਍∀䠀䰀堀开䬀䤀䰀䰀开䔀一䔀䴀䤀䔀匀开圀䤀吀䠀伀一䔀䔀一䔀刀䜀夀䈀䄀䰀䰀开䐀䔀匀䌀∀ऀ∀䴀愀琀愀 愀 㔀 攀渀攀洀椀最漀猀 挀漀渀 氀愀 洀椀猀洀愀 攀猀昀攀爀愀 搀攀 攀渀攀爀最愀⸀∀ഀഀ
"[english]HLX_KILL_ENEMIES_WITHONEENERGYBALL_DESC"	"Kill five enemies with the same energy ball."਍∀䠀䰀堀开䬀䤀䰀䰀开䔀䰀䤀吀䔀匀伀䰀䐀䤀䔀刀开圀䤀吀䠀䠀䤀匀䔀一䔀刀䜀夀䈀䄀䰀䰀开一䄀䴀䔀∀ऀ∀ꄀ䔀猀漀猀 爀攀昀氀攀樀漀猀℀∀ഀഀ
"[english]HLX_KILL_ELITESOLDIER_WITHHISENERGYBALL_NAME"	"Think Fast!"਍∀䠀䰀堀开䬀䤀䰀䰀开䔀䰀䤀吀䔀匀伀䰀䐀䤀䔀刀开圀䤀吀䠀䠀䤀匀䔀一䔀刀䜀夀䈀䄀䰀䰀开䐀䔀匀䌀∀ऀ∀䴀愀琀愀 愀 甀渀 猀漀氀搀愀搀漀 搀攀 氀椀琀攀 挀漀渀 猀甀 瀀爀漀瀀椀愀 攀猀昀攀爀愀 搀攀 攀渀攀爀最愀⸀∀ഀഀ
"[english]HLX_KILL_ELITESOLDIER_WITHHISENERGYBALL_DESC"	"Kill an Elite Soldier with his own energy ball."਍∀䔀倀堀开䜀䔀吀开娀伀䴀䈀䤀一䔀䜀刀䔀一䄀䐀䔀开一䄀䴀䔀∀ऀ∀䰀愀搀爀渀 搀攀 琀甀洀戀愀猀∀ഀഀ
"[english]EPX_GET_ZOMBINEGRENADE_NAME"	"Grave Robber"਍∀䔀倀堀开䜀䔀吀开娀伀䴀䈀䤀一䔀䜀刀䔀一䄀䐀䔀开䐀䔀匀䌀∀ऀ∀刀漀戀愀 氀愀 最爀愀渀愀搀愀 搀攀 甀渀 愀氀椀稀漀洀戀椀⸀∀ഀഀ
"[english]EPX_GET_ZOMBINEGRENADE_DESC"	"Steal a Zombine's grenade."਍∀䔀倀堀开䬀䤀䰀䰀开娀伀䴀䈀䤀䔀匀开圀䤀吀䠀䘀䰀䄀刀䔀匀开一䄀䴀䔀∀ऀ∀娀漀洀戀椀挀漀愀∀ഀഀ
"[english]EPX_KILL_ZOMBIES_WITHFLARES_NAME"	"Zombie-que"਍∀䔀倀堀开䬀䤀䰀䰀开娀伀䴀䈀䤀䔀匀开圀䤀吀䠀䘀䰀䄀刀䔀匀开䐀䔀匀䌀∀ऀ∀唀猀愀 戀攀渀最愀氀愀猀 瀀愀爀愀 瀀爀攀渀搀攀爀 昀甀攀最漀 愀 ㄀㔀 稀漀洀戀椀猀⸀∀ഀഀ
"[english]EPX_KILL_ZOMBIES_WITHFLARES_DESC"	"Use flares to light 15 zombies on fire."਍∀䜀愀洀攀唀䤀开䰀愀渀最甀愀最攀开䔀渀最氀椀猀栀∀ऀ∀䔀渀最氀椀猀栀 ⠀椀渀最氀猀⤀∀ഀഀ
"[english]GameUI_Language_English"	"English"਍∀䜀愀洀攀唀䤀开䰀愀渀最甀愀最攀开䜀攀爀洀愀渀∀ऀ∀䄀氀攀洀渀∀ഀഀ
"[english]GameUI_Language_German"	"German"਍∀䜀愀洀攀唀䤀开䰀愀渀最甀愀最攀开䘀爀攀渀挀栀∀ऀ∀䘀爀愀渀挀猀∀ഀഀ
"[english]GameUI_Language_French"	"French"਍∀䜀愀洀攀唀䤀开䰀愀渀最甀愀最攀开䤀琀愀氀椀愀渀∀ऀ∀䤀琀愀氀椀愀渀漀∀ഀഀ
"[english]GameUI_Language_Italian"	"Italian"਍∀䜀愀洀攀唀䤀开䰀愀渀最甀愀最攀开䬀漀爀攀愀渀∀ऀ∀䌀漀爀攀愀渀漀∀ഀഀ
"[english]GameUI_Language_Korean"	"Korean"਍∀䜀愀洀攀唀䤀开䰀愀渀最甀愀最攀开匀瀀愀渀椀猀栀∀ऀ∀䔀猀瀀愀漀氀∀ഀഀ
"[english]GameUI_Language_Spanish"	"Spanish"਍∀䜀愀洀攀唀䤀开䰀愀渀最甀愀最攀开匀椀洀瀀氀椀昀椀攀搀开䌀栀椀渀攀猀攀∀ऀ∀䌀栀椀渀漀 猀椀洀瀀氀椀昀椀挀愀搀漀∀ഀഀ
"[english]GameUI_Language_Simplified_Chinese"	"Simplified_Chinese"਍∀䜀愀洀攀唀䤀开䰀愀渀最甀愀最攀开吀爀愀搀椀琀椀漀渀愀氀开䌀栀椀渀攀猀攀∀ऀ∀䌀栀椀渀漀 琀爀愀搀椀挀椀漀渀愀氀∀ഀഀ
"[english]GameUI_Language_Traditional_Chinese"	"Traditional_Chinese"਍∀䜀愀洀攀唀䤀开䰀愀渀最甀愀最攀开刀甀猀猀椀愀渀∀ऀ∀刀甀猀漀∀ഀഀ
"[english]GameUI_Language_Russian"	"Russian"਍∀䜀愀洀攀唀䤀开䰀愀渀最甀愀最攀开吀栀愀椀∀ऀ∀吀愀椀氀愀渀搀猀∀ഀഀ
"[english]GameUI_Language_Thai"	"Thai"਍∀䜀愀洀攀唀䤀开䰀愀渀最甀愀最攀开䨀愀瀀愀渀攀猀攀∀ऀ∀䨀愀瀀漀渀猀∀ഀഀ
"[english]GameUI_Language_Japanese"	"Japanese"਍∀䜀愀洀攀唀䤀开䰀愀渀最甀愀最攀开倀漀爀琀甀最甀攀猀攀∀ऀ∀倀漀爀琀甀最甀猀∀ഀഀ
"[english]GameUI_Language_Portuguese"	"Portuguese"਍∀䜀愀洀攀唀䤀开䰀愀渀最甀愀最攀开倀漀氀椀猀栀∀ऀ∀倀漀氀愀挀漀∀ഀഀ
"[english]GameUI_Language_Polish"	"Polish"਍∀䜀愀洀攀唀䤀开䰀愀渀最甀愀最攀开䐀愀渀椀猀栀∀ऀ∀䐀愀渀猀∀ഀഀ
"[english]GameUI_Language_Danish"	"Danish"਍∀䜀愀洀攀唀䤀开䰀愀渀最甀愀最攀开䐀甀琀挀栀∀ऀ∀一攀攀爀氀愀渀搀猀∀ഀഀ
"[english]GameUI_Language_Dutch"	"Dutch"਍∀䜀愀洀攀唀䤀开䰀愀渀最甀愀最攀开䘀椀渀渀椀猀栀∀ऀ∀䘀椀渀猀∀ഀഀ
"[english]GameUI_Language_Finnish"	"Finnish"਍∀䜀愀洀攀唀䤀开䰀愀渀最甀愀最攀开一漀爀眀攀最椀愀渀∀ऀ∀一漀爀甀攀最漀∀ഀഀ
"[english]GameUI_Language_Norwegian"	"Norwegian"਍∀䜀愀洀攀唀䤀开䰀愀渀最甀愀最攀开匀眀攀搀椀猀栀∀ऀ∀匀甀攀挀漀∀ഀഀ
"[english]GameUI_Language_Swedish"	"Swedish"਍∀䜀愀洀攀唀䤀开䰀漀愀搀䐀椀愀氀漀最开䠀爀开䴀椀渀∀ऀ∀─猀㄀ 栀 ─猀㈀ 洀椀渀∀ഀഀ
"[english]GameUI_LoadDialog_Hr_Min"	"%s1 hr %s2 min"਍∀䜀愀洀攀唀䤀开䰀漀愀搀䐀椀愀氀漀最开䴀椀渀开匀攀挀∀ऀ∀─猀㄀ 洀椀渀 ─猀㈀ 猀攀最∀ഀഀ
"[english]GameUI_LoadDialog_Min_Sec"	"%s1 min %s2 sec"਍∀䜀愀洀攀唀䤀开䰀漀愀搀䐀椀愀氀漀最开匀攀挀∀ऀ∀─猀㄀ 猀攀最甀渀搀漀猀∀ഀഀ
"[english]GameUI_LoadDialog_Sec"	"%s1 seconds"਍∀䜀愀洀攀唀䤀开䐀椀猀愀戀氀攀匀瀀爀愀礀猀∀ऀ∀䐀攀猀栀愀戀椀氀椀琀愀爀 愀攀爀漀猀漀氀攀猀∀ഀഀ
"[english]GameUI_DisableSprays"	"Disable Sprays"਍∀䜀愀洀攀唀䤀开䘀伀嘀∀ऀ∀䌀愀洀瀀漀 搀攀 瘀椀猀椀渀∀ഀഀ
"[english]GameUI_FOV"	"Field of view"਍∀䜀愀洀攀唀䤀开䔀渀愀戀氀攀䠀唀䐀䴀椀渀䴀漀搀攀∀ऀ∀䠀愀戀椀氀椀琀愀爀 䠀唀䐀 洀渀椀洀漀∀ഀഀ
"[english]GameUI_EnableHUDMinMode"	"Enable Minimal HUD"਍∀䜀愀洀攀唀䤀开䐀漀眀渀氀漀愀搀䘀椀氀琀攀爀开吀椀琀氀攀∀ऀ∀䌀甀愀渀搀漀 甀渀 猀攀爀瘀椀搀漀爀 搀攀 樀甀攀最漀 椀渀琀攀渀琀愀尀渀搀攀猀挀愀爀最愀爀 挀漀渀琀攀渀椀搀漀 瀀攀爀猀漀渀愀氀椀稀愀搀漀∀ഀഀ
"[english]GameUI_DownloadFilter_Title"	"When a game server tries to download\ncustom content to your computer"਍∀䜀愀洀攀唀䤀开䐀漀眀渀氀漀愀搀䘀椀氀琀攀爀开䄀䰀䰀∀ऀ∀䄀搀洀椀琀椀爀 琀漀搀漀猀 氀漀猀 愀爀挀栀椀瘀漀猀 瀀攀爀猀漀渀愀氀椀稀愀搀漀猀 搀攀氀 猀攀爀瘀椀搀漀爀∀ഀഀ
"[english]GameUI_DownloadFilter_ALL"	"Allow all custom files from server"਍∀䜀愀洀攀唀䤀开䐀漀眀渀氀漀愀搀䘀椀氀琀攀爀开一漀匀漀甀渀搀猀∀ऀ∀一漀 搀攀猀挀愀爀最愀爀 愀甀搀椀漀 瀀攀爀猀漀渀愀氀椀稀愀搀漀∀ഀഀ
"[english]GameUI_DownloadFilter_NoSounds"	"Do not download custom sounds"਍∀䜀愀洀攀唀䤀开䐀漀眀渀氀漀愀搀䘀椀氀琀攀爀开一漀渀攀∀ऀ∀一漀 搀攀猀挀愀爀最愀爀 愀爀挀栀椀瘀漀猀 瀀攀爀猀漀渀愀氀椀稀愀搀漀猀∀ഀഀ
"[english]GameUI_DownloadFilter_None"	"Do not download any custom files"਍∀䜀愀洀攀唀䤀开䜀愀洀攀䴀攀渀甀开䌀栀愀爀愀挀琀攀爀匀攀琀甀瀀∀ऀ∀䤀一䘀伀 䐀䔀 倀䔀刀匀伀一䄀䨀䔀 夀 倀刀䔀倀䄀刀䄀䌀䤀팀一∀ഀഀ
"[english]GameUI_GameMenu_CharacterSetup"	"CHARACTER INFO AND SETUP"਍∀䜀愀洀攀唀䤀开䌀甀猀琀漀洀吀愀戀开吀椀琀氀攀∀ऀ∀匀攀爀瘀椀搀漀爀攀猀 瀀攀爀猀漀渀愀氀椀稀愀搀漀猀∀ഀഀ
"[english]GameUI_CustomTab_Title"	"Custom Servers"਍∀䜀愀洀攀唀䤀开䌀甀猀琀漀洀吀愀戀开䔀砀瀀氀愀渀愀琀椀漀渀∀ऀ∀䔀氀 攀砀瀀氀漀爀愀搀漀爀 搀攀 猀攀爀瘀椀搀漀爀攀猀 挀甀攀渀琀愀 挀漀渀 甀渀愀 渀甀攀瘀愀 瀀攀猀琀愀愀 攀渀 氀漀 愀氀琀漀 搀攀 氀愀 瘀攀渀琀愀渀愀㨀 ✀倀攀爀猀漀渀愀氀椀稀愀搀漀✀⸀∀ഀഀ
"[english]GameUI_CustomTab_Explanation"	"The server browser has a new tab at the top of the window called 'Custom'"਍∀䜀愀洀攀唀䤀开䌀甀猀琀漀洀吀愀戀开䔀砀瀀氀愀渀愀琀椀漀渀㈀∀ऀ∀䰀漀猀 猀攀爀瘀椀搀漀爀攀猀 攀渀甀洀攀爀愀搀漀猀 攀渀 攀氀氀愀 栀愀渀 猀椀搀漀 洀漀搀椀昀椀挀愀搀漀猀 瀀漀爀 洀椀攀洀戀爀漀猀 搀攀 氀愀 挀漀洀甀渀椀搀愀搀 瀀愀爀愀 挀愀洀戀椀愀爀 氀愀 攀砀瀀攀爀椀攀渀挀椀愀 搀攀 樀甀攀最漀 渀漀爀洀愀氀⸀ 匀椀 琀攀 愀瀀攀琀攀挀攀 瀀爀漀戀愀爀 瘀攀爀猀椀漀渀攀猀 洀漀搀椀昀椀挀愀搀愀猀 搀攀 ─最愀洀攀─Ⰰ 挀漀渀猀甀氀琀愀 氀愀 昀椀挀栀愀 倀攀爀猀漀渀愀氀椀稀愀搀漀⸀∀ഀഀ
"[english]GameUI_CustomTab_Explanation2"	"Servers listed there have been modified by members of the community to change the default game experience. Try clicking the custom tab if you want to play modified versions of %game%."਍∀䜀愀洀攀唀䤀开䌀甀猀琀漀洀吀愀戀开䔀砀瀀氀愀渀愀琀椀漀渀㌀∀ऀ∀倀甀攀搀攀猀 栀愀挀攀爀 挀氀椀挀 攀渀 攀氀 猀椀最甀椀攀渀琀攀 瘀渀挀甀氀漀 瀀愀爀愀 漀戀琀攀渀攀爀 洀猀 椀渀昀漀爀洀愀挀椀渀 愀挀攀爀挀愀 搀攀 氀漀猀 猀攀爀瘀椀搀漀爀攀猀 瀀攀爀猀漀渀愀氀椀稀愀搀漀猀 ⠀氀愀 瀀最椀渀愀 猀攀 愀戀爀椀爀 攀渀 琀甀 渀愀瘀攀最愀搀漀爀 瀀爀攀搀攀琀攀爀洀椀渀愀搀漀⤀⸀∀ഀഀ
"[english]GameUI_CustomTab_Explanation3"	"You can click the following link to read more about custom servers (link will open your default web browser)"਍∀䜀愀洀攀唀䤀开䌀甀猀琀漀洀吀愀戀开䰀椀渀欀∀ऀ∀䴀猀 椀渀昀漀爀洀愀挀椀渀 猀漀戀爀攀 猀攀爀瘀椀搀漀爀攀猀 瀀攀爀猀漀渀愀氀椀稀愀搀漀猀∀ഀഀ
"[english]GameUI_CustomTab_Link"	"More information about custom servers"਍∀䜀愀洀攀唀䤀开䴀甀氀琀椀挀漀爀攀刀攀渀搀攀爀椀渀最∀ऀ∀刀攀渀搀攀爀椀稀愀搀漀 洀甀氀琀椀渀切挀氀攀漀∀ഀഀ
"[english]GameUI_MulticoreRendering"	"Multicore Rendering"਍∀䜀愀洀攀唀䤀开䠀愀瀀琀椀挀猀开吀愀戀吀椀琀氀攀∀ऀ∀䘀愀氀挀漀渀∀ഀഀ
"[english]GameUI_Haptics_TabTitle"	"Falcon"਍∀䜀愀洀攀唀䤀开䠀愀瀀琀椀挀猀开䰀漀眀∀ऀ∀䈀愀樀漀∀ഀഀ
"[english]GameUI_Haptics_Low"	"Low"਍∀䜀愀洀攀唀䤀开䠀愀瀀琀椀挀猀开䠀椀最栀∀ऀ∀䄀氀琀漀∀ഀഀ
"[english]GameUI_Haptics_High"	"High"਍∀䜀愀洀攀唀䤀开䠀愀瀀琀椀挀猀开䘀漀爀挀攀䴀愀猀琀攀爀匀挀愀氀攀∀ऀ∀䘀漀爀稀愀爀 䔀猀挀愀氀愀 䴀愀攀猀琀爀愀∀ഀഀ
"[english]GameUI_Haptics_ForceMasterScale"	"Force Master Scale"਍∀䜀愀洀攀唀䤀开䠀愀瀀琀椀挀猀开刀攀挀漀椀氀匀挀愀氀攀∀ऀ∀䘀甀攀爀稀愀猀 搀攀 刀攀琀爀漀挀攀猀漀∀ഀഀ
"[english]GameUI_Haptics_RecoilScale"	"Recoil Forces"਍∀䜀愀洀攀唀䤀开䠀愀瀀琀椀挀猀开䐀愀洀愀最攀匀挀愀氀攀∀ऀ∀䘀甀攀爀稀愀猀 搀攀 䐀愀漀∀ഀഀ
"[english]GameUI_Haptics_DamageScale"	"Damage Forces"਍∀䜀愀洀攀唀䤀开䠀愀瀀琀椀挀猀开䴀漀瘀攀洀攀渀琀匀挀愀氀攀∀ऀ∀䘀甀攀爀稀愀猀 搀攀氀 䔀渀琀漀爀渀漀∀ഀഀ
"[english]GameUI_Haptics_MovementScale"	"Environment Forces"਍∀䜀愀洀攀唀䤀开䠀愀瀀琀椀挀猀开倀氀愀礀攀爀䈀漀砀匀挀愀氀攀∀ऀ∀䔀猀挀愀氀愀 倀漀氀椀最漀渀愀氀 搀攀氀 䨀甀最愀搀漀爀∀ഀഀ
"[english]GameUI_Haptics_PlayerBoxScale"	"Player Box Scale"਍∀䜀愀洀攀唀䤀开䠀愀瀀琀椀挀猀开倀氀愀礀攀爀䈀漀砀䰀愀戀攀氀∀ऀ∀䌀漀渀琀爀漀氀 搀攀氀 樀甀最愀搀漀爀∀ഀഀ
"[english]GameUI_Haptics_PlayerBoxLabel"	"Player Control"਍∀䜀愀洀攀唀䤀开䠀愀瀀琀椀挀猀开倀氀愀礀攀爀䈀漀砀匀琀椀昀昀渀攀猀猀∀ऀ∀刀椀最椀搀攀稀∀ഀഀ
"[english]GameUI_Haptics_PlayerBoxStiffness"	"Stiffness"਍∀䜀愀洀攀唀䤀开䠀愀瀀琀椀挀猀开匀挀愀氀攀∀ऀ∀䔀猀挀愀氀愀∀ഀഀ
"[english]GameUI_Haptics_Scale"	"Scale"਍∀䜀愀洀攀唀䤀开䠀愀瀀琀椀挀猀开嘀攀栀椀挀氀攀䈀漀砀䰀愀戀攀氀∀ऀ∀䌀漀渀琀爀漀氀 搀攀氀 瘀攀栀挀甀氀漀∀ഀഀ
"[english]GameUI_Haptics_VehicleBoxLabel"	"Vehicle Control"਍∀䜀愀洀攀唀䤀开䠀愀瀀琀椀挀猀开嘀攀栀椀挀氀攀䈀漀砀匀琀椀昀昀渀攀猀猀∀ऀ∀刀椀最椀搀攀稀∀ഀഀ
"[english]GameUI_Haptics_VehicleBoxStiffness"	"Stiffness"਍∀䜀愀洀攀唀䤀开䠀愀瀀琀椀挀猀开吀甀爀渀椀渀最∀ऀ∀匀攀渀猀椀戀椀氀椀搀愀搀 搀攀 最椀爀漀∀ഀഀ
"[english]GameUI_Haptics_Turning"	"Turn Sensitivity"਍∀䜀愀洀攀唀䤀开䠀愀瀀琀椀挀猀开䄀椀洀椀渀最∀ऀ∀匀攀渀猀椀戀椀氀椀搀愀搀 搀攀 愀瀀甀渀琀愀搀漀∀ഀഀ
"[english]GameUI_Haptics_Aiming"	"Aim Sensitivity"਍∀䜀愀洀攀唀䤀开一漀匀琀攀愀洀匀琀愀琀猀吀爀愀挀欀椀渀最∀ऀ∀倀愀爀愀 瀀漀搀攀爀 猀攀最甀椀爀 琀甀猀 攀猀琀愀搀猀琀椀挀愀猀 渀攀挀攀猀椀琀愀猀 甀渀愀 挀漀渀攀砀椀渀 愀 匀琀攀愀洀⸀尀渀匀攀 琀攀 椀渀昀漀爀洀愀爀 甀渀愀 瘀攀稀 焀甀攀 猀攀 栀愀礀愀 攀猀琀愀戀氀攀挀椀搀漀 氀愀 挀漀渀攀砀椀渀⸀∀ഀഀ
"[english]GameUI_NoSteamStatsTracking"	"A connection to Steam is required in order to track your statistics.\nOnce a connection has been established you will be notified."਍∀䜀愀洀攀唀䤀开匀琀攀愀洀匀琀愀琀猀一漀眀吀爀愀挀欀椀渀最∀ऀ∀匀攀 栀愀 攀猀琀愀戀氀攀挀椀搀漀 挀漀渀攀砀椀渀 挀漀渀 匀琀攀愀洀Ⰰ 琀甀猀 攀猀琀愀搀猀琀椀挀愀猀 猀攀爀渀 猀攀最甀椀搀愀猀⸀∀ഀഀ
"[english]GameUI_SteamStatsNowTracking"	"A connection to Steam has been established and your statistics will now be tracked."਍∀䜀愀洀攀唀䤀开䜀愀洀攀䴀攀渀甀开䴀愀椀渀䴀攀渀甀∀ऀ∀䴀䔀一 倀刀䤀一䌀䤀倀䄀䰀∀ഀഀ
"[english]GameUI_GameMenu_MainMenu"	"MAIN MENU"਍∀䜀愀洀攀唀䤀开䜀愀洀攀䴀攀渀甀开吀爀愀椀渀椀渀最∀ऀ∀吀唀吀伀刀䤀䄀䰀∀ഀഀ
"[english]GameUI_GameMenu_Training"	"TUTORIAL"਍∀䜀愀洀攀唀䤀开䜀愀洀攀䴀攀渀甀开伀昀昀氀椀渀攀倀爀愀挀琀椀挀攀∀ऀ∀倀刀䄀䌀吀䤀䌀䄀刀 䤀一䐀䤀嘀䤀䐀唀䄀䰀䴀䔀一吀䔀∀ഀഀ
"[english]GameUI_GameMenu_OfflinePractice"	"OFFLINE PRACTICE"਍∀䜀愀洀攀唀䤀开刀攀猀攀琀匀琀愀琀猀∀ऀ∀刀攀椀渀椀挀椀愀爀 攀猀琀愀搀猀琀椀挀愀猀∀ഀഀ
"[english]GameUI_ResetStats"	"Reset All Stats"਍∀䜀愀洀攀唀䤀开䌀漀渀昀椀爀洀刀攀猀攀琀匀琀愀琀猀吀椀琀氀攀∀ऀ∀刀攀椀渀椀挀椀愀爀 攀猀琀愀搀猀琀椀挀愀猀∀ഀഀ
"[english]GameUI_ConfirmResetStatsTitle"	"Reset All Stats"਍∀䜀愀洀攀唀䤀开䌀漀渀昀椀爀洀刀攀猀攀琀匀琀愀琀猀吀攀砀琀∀ऀ∀뼀䔀猀琀猀 猀攀最甀爀漀 搀攀 焀甀攀 焀甀椀攀爀攀猀 爀攀椀渀椀挀椀愀爀 琀漀搀愀猀 氀愀猀 攀猀琀愀搀猀琀椀挀愀猀㼀 䌀漀渀猀攀爀瘀愀爀猀 氀漀猀 氀漀最爀漀猀 礀愀 搀攀猀戀氀漀焀甀攀愀搀漀猀Ⰰ 瀀攀爀漀 氀漀猀 瀀爀漀最爀攀猀漀猀 搀攀 愀焀甀攀氀氀漀猀 焀甀攀 琀漀搀愀瘀愀 渀漀 栀愀猀 搀攀猀戀氀漀焀甀攀愀搀漀 猀攀 瀀攀爀搀攀爀渀⸀∀ഀഀ
"[english]GameUI_ConfirmResetStatsText"	"Are you sure you want to reset all stats?  You will keep existing achievements, but progress towards future achievements will be lost."਍∀䜀愀洀攀唀䤀开刀攀猀攀琀∀ऀ∀刀攀椀渀椀挀椀愀爀 攀猀琀愀搀猀琀椀挀愀猀∀ഀഀ
"[english]GameUI_Reset"	"Reset All Stats"਍∀䜀愀洀攀唀䤀开䜀愀洀攀䴀攀渀甀开匀琀漀爀攀∀ऀ∀吀䤀䔀一䐀䄀 䐀䔀 伀䈀䨀䔀吀伀匀∀ഀഀ
"[english]GameUI_GameMenu_Store"	"SHOP FOR ITEMS"਍∀䜀愀洀攀唀䤀开匀渀搀䴀甀琀攀䰀漀猀攀䘀漀挀甀猀∀ऀ∀匀椀氀攀渀挀椀愀爀 攀氀 猀漀渀椀搀漀 挀甀愀渀搀漀 攀氀 樀甀攀最漀 猀攀 攀渀挀甀攀渀琀爀攀 攀渀 猀攀最甀渀搀漀 瀀氀愀渀漀⸀∀ഀഀ
"[english]GameUI_SndMuteLoseFocus"	"Silence the audio while the game window is in the background."਍∀䜀愀洀攀唀䤀开䌀氀漀猀攀䈀爀漀眀猀攀爀伀渀䌀漀渀渀攀挀琀∀ऀ∀䌀攀爀爀愀爀 攀氀 攀砀瀀氀漀爀愀搀漀爀 搀攀 猀攀爀瘀椀搀漀爀攀猀 搀攀猀瀀甀猀 搀攀 挀漀渀攀挀琀愀爀猀攀 愀 甀渀 猀攀爀瘀椀搀漀爀⸀∀ഀഀ
"[english]GameUI_CloseBrowserOnConnect"	"Close the server browser after connecting to a server."਍∀䜀愀洀攀唀䤀开䴀漀甀猀攀刀愀眀∀ऀ∀䔀渀琀爀愀搀愀 搀椀爀攀挀琀愀∀ഀഀ
"[english]GameUI_MouseRaw"	"Raw input"਍∀䜀愀洀攀唀䤀开䴀漀甀猀攀刀愀眀开䠀椀渀琀∀ऀ∀䰀愀 攀渀琀爀愀搀愀 搀椀爀攀挀琀愀 氀攀攀 攀氀 洀漀瘀椀洀椀攀渀琀漀 搀攀氀 爀愀琀渀 搀椀爀攀挀琀愀洀攀渀琀攀 搀攀猀搀攀 攀氀 搀椀猀瀀漀猀椀琀椀瘀漀Ⰰ 攀氀甀搀椀攀渀搀漀 氀愀 挀漀渀昀椀最甀爀愀挀椀渀 搀攀氀 瀀愀渀攀氀 搀攀 挀漀渀琀爀漀氀 礀 瀀爀漀瀀漀爀挀椀漀渀愀渀搀漀 甀渀 洀漀瘀椀洀椀攀渀琀漀 洀猀 昀椀愀戀氀攀⸀∀ഀഀ
"[english]GameUI_MouseRaw_Hint"	"Raw input reads mouse movement directly from the device, bypassing control panel mouse settings, and providing more reliable mouse movement."਍∀䜀愀洀攀唀䤀开䴀漀甀猀攀䄀挀挀攀氀攀爀愀琀椀漀渀∀ऀ∀䄀挀攀氀攀爀愀挀椀渀 搀攀氀 爀愀琀渀∀ഀഀ
"[english]GameUI_MouseAcceleration"	"Mouse acceleration"਍∀䜀愀洀攀唀䤀开䴀漀甀猀攀䄀挀挀攀氀攀爀愀琀椀漀渀开䠀椀渀琀∀ऀ∀䄀挀琀椀瘀愀爀 愀挀攀氀攀爀愀挀椀渀 搀攀氀 爀愀琀渀 ⠀爀攀挀漀洀攀渀搀愀搀漀 猀椀 甀猀愀猀 攀渀琀爀愀搀愀 搀椀爀攀挀琀愀 搀攀 搀愀琀漀猀⤀∀ഀഀ
"[english]GameUI_MouseAcceleration_Hint"	"Enable mouse acceleration (recommended when using raw input)"਍∀䜀愀洀攀唀䤀开䴀漀甀猀攀䄀挀挀攀氀攀爀愀琀椀漀渀䄀洀漀甀渀琀开䠀椀渀琀∀ऀ∀䌀愀渀琀椀搀愀搀 搀攀 愀挀攀氀攀爀愀挀椀渀⸀ 唀渀 瘀愀氀漀爀 搀攀 ㄀⸀　 渀漀 瀀爀漀瀀漀爀挀椀漀渀愀 愀挀攀氀攀爀愀挀椀渀㬀 瘀愀氀漀爀攀猀 猀甀瀀攀爀椀漀爀攀猀 瀀爀漀瀀漀爀挀椀漀渀愀爀渀 愀挀攀氀攀爀愀挀椀渀 愀搀椀挀椀漀渀愀氀⸀∀ഀഀ
"[english]GameUI_MouseAccelerationAmount_Hint"	"Amount of acceleration. A value of 1.0 is unaccelerated; higher values will provide additional acceleration."਍∀䜀愀洀攀唀䤀开匀攀爀瘀攀爀䌀漀渀渀攀挀琀伀甀琀伀昀䐀愀琀攀∀ऀ∀䔀氀 猀攀爀瘀椀搀漀爀 渀漀 栀愀 猀椀搀漀 愀挀琀甀愀氀椀稀愀搀漀 愀 氀愀 瘀攀爀猀椀渀 洀猀 爀攀挀椀攀渀琀攀⸀尀渀∀ഀഀ
"[english]GameUI_ServerConnectOutOfDate"	"Server has not updated to the most recent version.\n"਍∀䜀愀洀攀唀䤀开匀攀爀瘀攀爀䌀栀愀氀氀攀渀最攀䤀渀挀漀爀爀攀挀琀∀ऀ∀䔀氀 猀攀爀瘀椀搀漀爀 渀漀 爀攀猀瀀漀渀搀椀 挀漀渀 攀氀 瀀爀漀琀漀挀漀氀漀 愀搀攀挀甀愀搀漀⸀尀渀倀甀攀搀攀 焀甀攀 渀漀 攀猀琀 愀挀琀甀愀氀椀稀愀搀漀⸀尀渀∀ഀഀ
"[english]GameUI_ServerChallengeIncorrect"	"Server did not respond with the correct challenge.\nIt may be out of date.\n"਍∀䜀愀洀攀唀䤀开匀攀爀瘀攀爀䤀渀猀攀挀甀爀攀∀ऀ∀䔀猀琀猀 攀渀 洀漀搀漀 椀渀猀攀最甀爀漀⸀ 䐀攀戀攀猀 爀攀椀渀椀挀椀愀爀 愀渀琀攀猀 搀攀 焀甀攀 瀀甀攀搀愀猀 挀漀渀攀挀琀愀爀琀攀 愀 猀攀爀瘀椀搀漀爀攀猀 猀攀最甀爀漀猀⸀尀渀∀ഀഀ
"[english]GameUI_ServerInsecure"	"You are in insecure mode.  You must restart before you can connect to secure servers.\n"਍∀䜀愀洀攀唀䤀开匀攀爀瘀攀爀刀攀樀攀挀琀䈀愀搀䌀栀愀氀氀攀渀最攀∀ऀ∀倀爀漀琀漀挀漀氀漀 椀渀挀漀爀爀攀挀琀漀⸀尀渀∀ഀഀ
"[english]GameUI_ServerRejectBadChallenge"	"Bad challenge.\n"਍∀䜀愀洀攀唀䤀开匀攀爀瘀攀爀刀攀樀攀挀琀䰀䄀一刀攀猀琀爀椀挀琀∀ऀ∀䰀漀猀 猀攀爀瘀椀搀漀爀攀猀 䰀䄀一 攀猀琀渀 爀攀猀琀爀椀渀最椀搀漀猀 愀 氀漀猀 挀氀椀攀渀琀攀猀 氀漀挀愀氀攀猀 ⠀挀氀愀猀攀 䌀⤀⸀尀渀∀ഀഀ
"[english]GameUI_ServerRejectLANRestrict"	"LAN servers are restricted to local clients (class C).\n"਍∀䜀愀洀攀唀䤀开匀攀爀瘀攀爀刀攀樀攀挀琀䈀愀搀倀愀猀猀眀漀爀搀∀ऀ∀䌀漀渀琀爀愀猀攀愀 椀渀挀漀爀爀攀挀琀愀⸀尀渀∀ഀഀ
"[english]GameUI_ServerRejectBadPassword"	"Bad password.\n"਍∀䜀愀洀攀唀䤀开匀攀爀瘀攀爀刀攀樀攀挀琀匀攀爀瘀攀爀䘀甀氀氀∀ऀ∀䔀氀 猀攀爀瘀椀搀漀爀 攀猀琀 氀氀攀渀漀⸀尀渀∀ഀഀ
"[english]GameUI_ServerRejectServerFull"	"Server is full.\n"਍∀䜀愀洀攀唀䤀开匀攀爀瘀攀爀刀攀樀攀挀琀䈀愀渀渀攀搀∀ऀ∀吀攀 栀愀渀 戀氀漀焀甀攀愀搀漀 攀渀 攀猀琀攀 猀攀爀瘀椀搀漀爀⸀尀渀∀ഀഀ
"[english]GameUI_ServerRejectBanned"	"You have been banned from this server.\n"਍∀䜀愀洀攀唀䤀开匀攀爀瘀攀爀刀攀樀攀挀琀䘀愀椀氀攀搀䌀栀愀渀渀攀氀∀ऀ∀䔀爀爀漀爀 愀氀 挀爀攀愀爀 甀渀 挀愀渀愀氀 攀渀 氀渀攀愀⸀尀渀∀ഀഀ
"[english]GameUI_ServerRejectFailedChannel"	"Failed to create net channel.\n"਍∀䜀愀洀攀唀䤀开匀攀爀瘀攀爀刀攀樀攀挀琀伀氀搀嘀攀爀猀椀漀渀∀ऀ∀䔀氀 猀攀爀瘀椀搀漀爀 愀氀 焀甀攀 椀渀琀攀渀琀愀猀 挀漀渀攀挀琀愀爀琀攀 攀猀琀 攀樀攀挀甀琀愀搀漀尀渀甀渀愀 瘀攀爀猀椀渀 愀渀琀椀最甀愀 搀攀氀 樀甀攀最漀⸀尀渀∀ഀഀ
"[english]GameUI_ServerRejectOldVersion"	"The server you are trying to connect to is running\nan older version of the game.\n"਍∀䜀愀洀攀唀䤀开匀攀爀瘀攀爀刀攀樀攀挀琀䈀愀搀匀琀攀愀洀䬀攀礀∀ऀ∀䰀愀 氀漀渀最椀琀甀搀 搀攀 氀愀 挀氀愀瘀攀 搀攀 匀琀攀愀洀 渀漀 攀猀 瘀氀椀搀愀尀渀∀ഀഀ
"[english]GameUI_ServerRejectBadSteamKey"	"Invalid Steam key length\n"਍∀䜀愀洀攀唀䤀开匀攀爀瘀攀爀刀攀樀攀挀琀伀氀搀倀爀漀琀漀挀漀氀∀ऀ∀䔀猀琀攀 猀攀爀瘀椀搀漀爀 攀猀琀 甀猀愀渀搀漀 甀渀 瀀爀漀琀漀挀漀氀漀 洀猀 愀渀琀椀最甀漀 焀甀攀 攀氀 搀攀 琀甀 挀氀椀攀渀琀攀⸀尀渀∀ഀഀ
"[english]GameUI_ServerRejectOldProtocol"	"This server is using an older protocol than your client.\n"਍∀䜀愀洀攀唀䤀开匀攀爀瘀攀爀刀攀樀攀挀琀一攀眀倀爀漀琀漀挀漀氀∀ऀ∀䔀猀琀攀 猀攀爀瘀椀搀漀爀 攀猀琀 甀猀愀渀搀漀 甀渀 瀀爀漀琀漀挀漀氀漀 洀猀 渀甀攀瘀漀 焀甀攀 攀氀 搀攀 琀甀 挀氀椀攀渀琀攀⸀尀渀∀ഀഀ
"[english]GameUI_ServerRejectNewProtocol"	"This server is using a newer protocol than your client.\n"਍∀䜀愀洀攀唀䤀开匀攀爀瘀攀爀刀攀樀攀挀琀䤀渀瘀愀氀椀搀䌀漀渀渀攀挀琀椀漀渀∀ऀ∀䌀漀渀攀砀椀渀 渀漀 瘀氀椀搀愀⸀尀渀∀ഀഀ
"[english]GameUI_ServerRejectInvalidConnection"	"Invalid connection.\n"਍∀䜀愀洀攀唀䤀开匀攀爀瘀攀爀刀攀樀攀挀琀䤀渀瘀愀氀椀搀䌀攀爀琀䰀攀渀∀ऀ∀䰀愀 氀漀渀最椀琀甀搀 搀攀氀 挀攀爀琀椀昀椀挀愀搀漀 搀攀 愀甀琀攀渀琀椀挀愀挀椀渀 渀漀 攀猀 瘀氀椀搀愀⸀尀渀∀ഀഀ
"[english]GameUI_ServerRejectInvalidCertLen"	"Invalid authentication certificate length.\n"਍∀䜀愀洀攀唀䤀开匀攀爀瘀攀爀刀攀樀攀挀琀䤀渀瘀愀氀椀搀匀琀攀愀洀䌀攀爀琀䰀攀渀∀ऀ∀ꄀ䔀爀爀漀爀 攀渀 氀愀 氀漀渀最椀琀甀搀 搀攀氀 挀攀爀琀椀昀椀挀愀搀漀 搀攀 匀吀䔀䄀䴀℀尀渀∀ഀഀ
"[english]GameUI_ServerRejectInvalidSteamCertLen"	"STEAM certificate length error!\n"਍∀䜀愀洀攀唀䤀开匀攀爀瘀攀爀刀攀樀攀挀琀匀琀攀愀洀∀ऀ∀嘀愀氀椀搀愀挀椀渀 搀攀 匀吀䔀䄀䴀 爀攀挀栀愀稀愀搀愀尀渀∀ഀഀ
"[english]GameUI_ServerRejectSteam"	"STEAM validation rejected\n"਍∀䜀愀洀攀唀䤀开匀攀爀瘀攀爀刀攀樀攀挀琀䜀匀∀ऀ∀䘀愀氀氀漀 攀渀 䜀匀䌀爀攀愀琀攀䰀漀挀愀氀唀猀攀爀尀渀∀ഀഀ
"[english]GameUI_ServerRejectGS"	"GSCreateLocalUser failed\n"਍∀䜀愀洀攀唀䤀开匀攀爀瘀攀爀刀攀焀甀椀爀攀匀琀攀愀洀猀∀ऀ∀䔀猀琀攀 猀攀爀瘀椀搀漀爀 爀攀焀甀椀攀爀攀 焀甀攀 攀猀琀猀 攀樀攀挀甀琀愀渀搀漀 匀琀攀愀洀⸀尀渀∀ഀഀ
"[english]GameUI_ServerRequireSteams"	"The server requires that you be running Steam.\n"਍∀䜀愀洀攀唀䤀开匀攀爀瘀攀爀䄀甀琀栀䐀椀猀愀戀氀攀搀∀ऀ∀嘀攀爀椀昀椀挀愀挀椀渀 搀攀猀愀挀琀椀瘀愀搀愀⸀尀渀∀ഀഀ
"[english]GameUI_ServerAuthDisabled"	"Authentication disabled.\n"਍∀䜀愀洀攀唀䤀开匀攀爀瘀攀爀䌀䐀䬀攀礀䄀甀琀栀䤀渀瘀愀氀椀搀∀ऀ∀䰀愀 瘀攀爀椀昀椀挀愀挀椀渀 搀攀 氀愀 挀氀愀瘀攀 搀攀 瀀爀漀搀甀挀琀漀 渀漀 攀猀 瘀氀椀搀愀 瀀愀爀愀 猀攀爀瘀椀搀漀爀攀猀 搀攀 椀渀琀攀爀渀攀琀⸀尀渀∀ഀഀ
"[english]GameUI_ServerCDKeyAuthInvalid"	"CD Key authentication invalid for internet servers.\n"਍∀䜀愀洀攀唀䤀开匀攀爀瘀攀爀䤀渀瘀愀氀椀搀䌀䐀䬀攀礀∀ऀ∀䰀愀 挀氀愀瘀攀 搀攀 瀀爀漀搀甀挀琀漀 渀漀 攀猀 瘀氀椀搀愀⸀尀渀∀ഀഀ
"[english]GameUI_ServerInvalidCDKey"	"Invalid CD Key.\n"਍∀䜀愀洀攀唀䤀开匀攀爀瘀攀爀䌀䐀䬀攀礀䤀渀唀猀攀∀ऀ∀䰀愀 挀氀愀瘀攀 搀攀 瀀爀漀搀甀挀琀漀 礀愀 攀猀琀 攀渀 甀猀漀⸀尀渀∀ഀഀ
"[english]GameUI_ServerCDKeyInUse"	"CD Key already in use.\n"਍∀䜀愀洀攀唀䤀开䌀爀漀猀猀栀愀椀爀一漀渀攀∀ऀ∀一椀渀最甀渀愀∀ഀഀ
"[english]GameUI_CrosshairNone"	"None"਍∀䜀愀洀攀唀䤀开匀攀爀瘀攀爀刀攀樀攀挀琀一攀眀嘀攀爀猀椀漀渀∀ऀ∀䔀氀 猀攀爀瘀椀搀漀爀 愀氀 焀甀攀 椀渀琀攀渀琀愀猀 挀漀渀攀挀琀愀爀琀攀 攀猀琀 攀樀攀挀甀琀愀渀搀漀尀渀甀渀愀 瘀攀爀猀椀渀 洀猀 渀甀攀瘀愀 搀攀氀 樀甀攀最漀⸀尀渀∀ഀഀ
"[english]GameUI_ServerRejectNewVersion"	"The server you are trying to connect to is running\na newer version of the game.\n"਍∀䜀愀洀攀唀䤀开匀琀攀愀洀嘀漀椀挀攀∀ऀ∀䔀氀 䌀栀愀琀 搀攀 嘀漀稀 搀攀 匀琀攀愀洀 猀攀 甀猀愀 瀀漀爀 搀攀昀攀挀琀漀Ⰰ 瀀攀爀漀 愀氀最甀渀漀猀 猀攀爀瘀椀搀漀爀攀猀 瀀甀攀搀攀渀 琀攀渀攀爀 氀愀 挀漀渀昀椀最甀爀愀挀椀渀 愀渀琀椀最甀愀⸀∀ഀഀ
"[english]GameUI_SteamVoice"	"Steam Voice is used by default, but some servers may use the old settings below."਍∀䜀愀洀攀唀䤀开匀琀攀愀洀嘀漀椀挀攀匀攀琀琀椀渀最猀∀ऀ∀䄀樀甀猀琀攀猀 搀攀氀 䌀栀愀琀 搀攀 嘀漀稀 搀攀 匀琀攀愀洀∀ഀഀ
"[english]GameUI_SteamVoiceSettings"	"Steam Voice Settings"਍∀䜀愀洀攀唀䤀开䜀愀洀攀䴀攀渀甀开刀攀瀀氀愀礀䐀攀洀漀猀∀ऀ∀䜀刀䄀䈀䄀䌀䤀伀一䔀匀∀ഀഀ
"[english]GameUI_GameMenu_ReplayDemos"	"REPLAYS"਍∀䜀愀洀攀唀䤀开䜀愀洀攀䴀攀渀甀开刀攀猀甀洀攀刀攀瀀氀愀礀∀ऀ∀刀䔀倀刀伀䐀唀䌀䤀刀 䜀刀䄀䈀䄀䌀䤀팀一∀ഀഀ
"[english]GameUI_GameMenu_ResumeReplay"	"RESUME REPLAY"਍∀䜀愀洀攀唀䤀开䜀愀洀攀䴀攀渀甀开䔀砀椀琀刀攀瀀氀愀礀∀ऀ∀嘀伀䰀嘀䔀刀 䄀 䰀䄀匀 䜀刀䄀䈀䄀䌀䤀伀一䔀匀∀ഀഀ
"[english]GameUI_GameMenu_ExitReplay"	"BACK TO REPLAYS"਍∀䜀愀洀攀唀䤀开瘀漀琀攀开礀攀猀开戀椀渀搀椀渀最∀ऀ∀匀㨀 ─猀㄀∀ഀഀ
"[english]GameUI_vote_yes_binding"	"Yes: %s1"਍∀䜀愀洀攀唀䤀开瘀漀琀攀开渀漀开戀椀渀搀椀渀最∀ऀ∀一漀㨀 ─猀㄀∀ഀഀ
"[english]GameUI_vote_no_binding"	"No: %s1"਍∀䜀愀洀攀唀䤀开瘀漀琀攀开礀攀猀开琀愀氀氀礀∀ऀ∀匀∀ഀഀ
"[english]GameUI_vote_yes_tally"	"Yes"਍∀䜀愀洀攀唀䤀开瘀漀琀攀开渀漀开琀愀氀氀礀∀ऀ∀一漀∀ഀഀ
"[english]GameUI_vote_no_tally"	"No"਍∀䜀愀洀攀唀䤀开瘀漀琀攀开栀攀愀搀攀爀∀ऀ∀─猀㄀ 焀甀椀攀爀攀 栀愀挀攀爀 甀渀愀 瘀漀琀愀挀椀渀㨀∀ഀഀ
"[english]GameUI_vote_header"	"%s1 wants to call a vote:"਍∀嘀漀琀攀开渀漀琀椀昀椀挀愀琀椀漀渀开琀椀琀氀攀∀ऀ∀嘀漀琀愀挀椀渀 猀漀氀椀挀椀琀愀搀愀∀ഀഀ
"[english]Vote_notification_title"	"Vote Called"਍∀嘀漀琀攀开渀漀琀椀昀椀挀愀琀椀漀渀开琀攀砀琀∀ऀ∀̀─椀渀椀琀椀愀琀漀爀─ 焀甀椀攀爀攀 猀漀氀椀挀椀琀愀爀 甀渀愀 瘀漀琀愀挀椀渀∀ഀഀ
"[english]Vote_notification_text"	"%initiator% wants to call a vote"਍∀嘀漀琀攀开渀漀琀椀昀椀挀愀琀椀漀渀开瘀椀攀眀∀ऀ∀嘀攀爀∀ഀഀ
"[english]Vote_notification_view"	"View"਍∀䜀愀洀攀唀䤀开瘀漀琀攀开礀攀猀开椀渀猀琀爀甀挀琀椀漀渀开愀∀ऀ∀倀甀氀猀愀 匀吀䄀刀吀∀ഀഀ
"[english]GameUI_vote_yes_instruction_a"	"Press START"਍∀䜀愀洀攀唀䤀开瘀漀琀攀开渀漀开椀渀猀琀爀甀挀琀椀漀渀开愀∀ऀ∀倀甀氀猀愀 䈀䄀䌀䬀∀ഀഀ
"[english]GameUI_vote_no_instruction_a"	"Press BACK"਍∀䜀愀洀攀唀䤀开瘀漀琀攀开礀攀猀开椀渀猀琀爀甀挀琀椀漀渀开戀∀ऀ∀瀀愀爀愀 瘀漀琀愀爀 匀촀∀ഀഀ
"[english]GameUI_vote_yes_instruction_b"	"to vote YES"਍∀䜀愀洀攀唀䤀开瘀漀琀攀开渀漀开椀渀猀琀爀甀挀琀椀漀渀开戀∀ऀ∀瀀愀爀愀 瘀漀琀愀爀 一伀∀ഀഀ
"[english]GameUI_vote_no_instruction_b"	"to vote NO"਍∀䜀愀洀攀唀䤀开瘀漀琀攀开礀攀猀开瀀挀开椀渀猀琀爀甀挀琀椀漀渀∀ऀ∀倀甀氀猀愀 䘀㄀ 瀀愀爀愀 瘀漀琀愀爀 匀촀∀ഀഀ
"[english]GameUI_vote_yes_pc_instruction"	"Press F1 to vote YES"਍∀䜀愀洀攀唀䤀开瘀漀琀攀开渀漀开瀀挀开椀渀猀琀爀甀挀琀椀漀渀∀ऀ∀倀甀氀猀愀 䘀㈀ 瀀愀爀愀 瘀漀琀愀爀 一伀∀ഀഀ
"[english]GameUI_vote_no_pc_instruction"	"Press F2 to vote NO"਍∀䜀愀洀攀唀䤀开瘀漀琀攀开挀甀爀爀攀渀琀开瘀漀琀攀开挀漀甀渀琀∀ऀ∀刀攀挀甀攀渀琀漀 搀攀 瘀漀琀漀猀㨀∀ഀഀ
"[english]GameUI_vote_current_vote_count"	"Vote count:"਍∀䜀愀洀攀唀䤀开瘀漀琀攀开瀀愀猀猀攀搀∀ऀ∀嘀漀琀愀挀椀渀 愀挀攀瀀琀愀搀愀∀ഀഀ
"[english]GameUI_vote_passed"	"Vote Passed"਍∀䜀愀洀攀唀䤀开瘀漀琀攀开昀愀椀氀攀搀∀ऀ∀嘀漀琀愀挀椀渀 爀攀挀栀愀稀愀搀愀∀ഀഀ
"[english]GameUI_vote_failed"	"Vote Failed"਍∀䜀愀洀攀唀䤀开瘀漀琀攀开昀愀椀氀攀搀开焀甀漀爀甀洀∀ऀ∀一漀 栀愀渀 瘀漀琀愀搀漀 猀甀昀椀挀椀攀渀琀攀猀 樀甀最愀搀漀爀攀猀⸀∀ഀഀ
"[english]GameUI_vote_failed_quorum"	"Not enough players voted."਍∀䜀愀洀攀唀䤀开瘀漀琀攀开昀愀椀氀攀搀开礀攀猀渀漀∀ऀ∀一漀 栀愀渀 瘀漀琀愀搀漀 尀∀匀尀∀ 猀甀昀椀挀椀攀渀琀攀猀 樀甀最愀搀漀爀攀猀⸀∀ഀഀ
"[english]GameUI_vote_failed_yesno"	"Not enough players voted \"Yes.\""਍∀䜀愀洀攀唀䤀开瘀漀琀攀开昀愀椀氀攀搀开瘀漀琀攀开猀瀀愀洀∀ऀ∀䄀挀愀戀愀猀 搀攀 猀漀氀椀挀椀琀愀爀 甀渀愀 瘀漀琀愀挀椀渀 礀 渀漀 瀀漀搀爀猀 猀漀氀椀挀椀琀愀爀 栀愀猀琀愀 瀀愀猀愀搀漀猀 ─猀㄀ 猀攀最甀渀搀漀猀⸀∀ഀഀ
"[english]GameUI_vote_failed_vote_spam"	"You called a vote recently and can not call another for %s1 seconds."਍∀䜀愀洀攀唀䤀开瘀漀琀攀开昀愀椀氀攀搀开琀爀愀渀猀椀琀椀漀渀开瘀漀琀攀∀ऀ∀一漀 瀀甀攀搀攀猀 猀漀氀椀挀椀琀愀爀 甀渀愀 渀甀攀瘀愀 瘀漀琀愀挀椀渀 洀椀攀渀琀爀愀猀 漀琀爀漀猀 樀甀最愀搀漀爀攀猀 渀漀 栀愀礀愀渀 琀攀爀洀椀渀愀搀漀 搀攀 挀愀爀最愀爀⸀∀ഀഀ
"[english]GameUI_vote_failed_transition_vote"	"You cannot call a new vote while other players are still loading."਍∀䜀愀洀攀唀䤀开瘀漀琀攀开昀愀椀氀攀搀开搀椀猀愀戀氀攀搀开椀猀猀甀攀∀ऀ∀䔀氀 猀攀爀瘀椀搀漀爀 栀愀 搀攀猀愀挀琀椀瘀愀搀漀 攀猀琀愀 挀愀爀愀挀琀攀爀猀琀椀挀愀⸀∀ഀഀ
"[english]GameUI_vote_failed_disabled_issue"	"Server has disabled that issue."਍∀䜀愀洀攀唀䤀开瘀漀琀攀开昀愀椀氀攀搀开洀愀瀀开渀漀琀开昀漀甀渀搀∀ऀ∀䔀猀攀 洀愀瀀愀 渀漀 攀砀椀猀琀攀⸀∀ഀഀ
"[english]GameUI_vote_failed_map_not_found"	"That map does not exist."਍∀䜀愀洀攀唀䤀开瘀漀琀攀开昀愀椀氀攀搀开洀愀瀀开渀愀洀攀开爀攀焀甀椀爀攀搀∀ऀ∀䐀攀戀攀猀 攀猀瀀攀挀椀昀椀挀愀爀 甀渀 渀漀洀戀爀攀 搀攀 洀愀瀀愀⸀∀ഀഀ
"[english]GameUI_vote_failed_map_name_required"	"You must specify a map name."਍∀䜀愀洀攀唀䤀开瘀漀琀攀开昀愀椀氀攀搀开爀攀挀攀渀琀氀礀∀ऀ∀䔀猀琀愀 瘀漀琀愀挀椀渀 礀愀 栀愀 猀椀搀漀 猀漀氀椀挀椀琀愀搀愀 爀攀挀椀攀渀琀攀洀攀渀琀攀 礀 渀漀 瀀甀攀搀攀 猀漀氀椀挀椀琀愀爀猀攀 搀攀 渀甀攀瘀漀 栀愀猀琀愀 搀攀渀琀爀漀 搀攀 ─猀㄀ 猀攀最甀渀搀漀猀⸀∀ഀഀ
"[english]GameUI_vote_failed_recently"	"This vote was called recently and cannot be called again for %s1 seconds."਍∀䜀愀洀攀唀䤀开瘀漀琀攀开昀愀椀氀攀搀开琀攀愀洀开挀愀渀琀开挀愀氀氀∀ऀ∀吀甀 攀焀甀椀瀀漀 渀漀 瀀甀攀搀攀 猀漀氀椀挀椀琀愀爀 攀猀琀愀 瘀漀琀愀挀椀渀⸀∀ഀഀ
"[english]GameUI_vote_failed_team_cant_call"	"Your team cannot call this vote."਍∀䜀愀洀攀唀䤀开瘀漀琀攀开昀愀椀氀攀搀开眀愀椀琀椀渀最昀漀爀瀀氀愀礀攀爀猀∀ऀ∀嘀漀琀愀挀椀渀 渀漀 瀀攀爀洀椀琀椀搀愀⸀ 䔀猀瀀攀爀愀渀搀漀 䨀甀最愀搀漀爀攀猀⸀∀ഀഀ
"[english]GameUI_vote_failed_waitingforplayers"	"Voting not allowed while Waiting For Players."਍∀䜀愀洀攀唀䤀开瘀漀琀攀开昀愀椀氀攀搀开挀愀渀渀漀琀开欀椀挀欀开愀搀洀椀渀∀ऀ∀一漀 瀀甀攀搀攀猀 瘀漀琀愀爀 瀀愀爀愀 攀砀瀀甀氀猀愀爀 愀氀 愀搀洀椀渀椀猀琀爀愀搀漀爀 搀攀氀 猀攀爀瘀椀搀漀爀⸀∀ഀഀ
"[english]GameUI_vote_failed_cannot_kick_admin"	"You may not vote to kick the server admin."਍∀䜀愀洀攀唀䤀开瘀漀琀攀开昀愀椀氀攀搀开猀挀爀愀洀戀氀攀开椀渀开瀀爀漀最∀ऀ∀䰀愀 䴀攀稀挀氀愀 搀攀 䔀焀甀椀瀀漀猀 攀猀琀 攀渀 瀀爀漀最爀攀猀漀⸀∀ഀഀ
"[english]GameUI_vote_failed_scramble_in_prog"	"A Team Scramble is in progress."਍∀䜀愀洀攀唀䤀开瘀漀琀攀开昀愀椀氀攀搀开猀瀀攀挀琀愀琀漀爀∀ऀ∀䔀猀琀攀 猀攀爀瘀椀搀漀爀 渀漀 瀀攀爀洀椀琀攀 瘀漀琀愀爀 愀 氀漀猀 䔀猀瀀攀挀琀愀搀漀爀攀猀⸀∀ഀഀ
"[english]GameUI_vote_failed_spectator"	"This server has disabled voting for Spectators."਍∀䜀愀洀攀唀䤀开瘀漀琀攀开攀砀琀攀渀搀开挀甀爀爀攀渀琀开洀愀瀀∀ऀ∀䔀砀琀攀渀搀攀爀 洀愀瀀愀 愀挀琀甀愀氀⸀∀ഀഀ
"[english]GameUI_vote_extend_current_map"	"Extend current Map."਍∀䜀愀洀攀唀䤀开瘀漀琀攀开礀攀猀∀ऀ∀嘀漀琀愀爀 匀 攀渀 愀猀甀渀琀漀 愀挀琀椀瘀漀∀ഀഀ
"[english]GameUI_vote_yes"	"Vote yes on active issue"਍∀䜀愀洀攀唀䤀开瘀漀琀攀开渀漀∀ऀ∀嘀漀琀愀爀 一漀 攀渀 愀猀甀渀琀漀 愀挀琀椀瘀漀∀ഀഀ
"[english]GameUI_vote_no"	"Vote no on active issue"਍∀䜀愀洀攀唀䤀开挀愀氀氀开瘀漀琀攀∀ऀ∀倀攀搀椀爀 瘀漀琀漀猀∀ഀഀ
"[english]GameUI_call_vote"	"Call vote"਍∀䜀愀洀攀唀䤀开䌀愀渀挀攀氀䈀漀氀搀∀ऀ∀䌀䄀一䌀䔀䰀䄀刀∀ഀഀ
"[english]GameUI_CancelBold"	"CANCEL"਍∀䜀愀洀攀唀䤀开䰀愀渀最甀愀最攀开刀漀洀愀渀椀愀渀∀ऀ∀刀甀洀愀渀漀∀ഀഀ
"[english]GameUI_Language_Romanian"	"Romanian"਍∀䜀愀洀攀唀䤀开䰀愀渀最甀愀最攀开吀甀爀欀椀猀栀∀ऀ∀吀甀爀挀漀∀ഀഀ
"[english]GameUI_Language_Turkish"	"Turkish"਍∀䜀愀洀攀唀䤀开䰀愀渀最甀愀最攀开䠀甀渀最愀爀椀愀渀∀ऀ∀䠀切渀最愀爀漀∀ഀഀ
"[english]GameUI_Language_Hungarian"	"Hungarian"਍∀䜀愀洀攀唀䤀开䌀漀渀昀椀爀洀∀ऀ∀䌀伀一䘀䤀刀䴀䄀刀∀ഀഀ
"[english]GameUI_Confirm"	"CONFIRM"਍∀䜀愀洀攀唀䤀开䐀㌀䐀㤀䔀砀∀ऀ∀䔀砀琀攀渀猀椀漀渀攀猀 搀攀 圀椀渀搀漀眀猀 䄀攀爀漀㨀∀ഀഀ
"[english]GameUI_D3D9Ex"	"Windows Aero extensions:"਍∀䜀愀洀攀唀䤀开䐀㌀䐀㤀䔀砀刀攀氀愀甀渀挀栀䴀猀最∀ऀ∀䔀猀琀愀 挀漀渀昀椀最甀爀愀挀椀渀 渀漀 猀攀爀 攀昀攀挀琀椀瘀愀 栀愀猀琀愀 焀甀攀 爀攀椀渀椀挀椀攀猀 攀氀 樀甀攀最漀⸀∀ഀഀ
"[english]GameUI_D3D9ExRelaunchMsg"	"This setting will not take effect until you exit and re-launch the game."਍∀䜀愀洀攀唀䤀开瘀漀琀攀开昀愀椀氀攀搀开洀愀瀀开渀漀琀开瘀愀氀椀搀∀ऀ∀䔀猀攀 洀愀瀀愀 渀漀 猀攀 攀渀挀甀攀渀琀爀愀 攀渀 攀氀 挀椀挀氀漀 搀攀 洀愀瀀愀猀 搀攀氀 猀攀爀瘀椀搀漀爀⸀∀ഀഀ
"[english]GameUI_vote_failed_map_not_valid"	"That map was not found in the server's map cycle."਍∀䐀伀吀䄀开吀漀漀氀琀椀瀀开愀戀椀氀椀琀礀开氀椀挀栀开挀栀愀椀渀开昀爀漀猀琀开挀愀猀琀开爀愀渀最攀开猀挀攀瀀琀攀爀∀ऀ∀䄀䰀䌀䄀一䌀䔀 䐀䔀 䰀䄀一娀䄀䴀䤀䔀一吀伀 䌀伀一 䌀䔀吀刀伀㨀∀ഀഀ
"[english]DOTA_Tooltip_ability_lich_chain_frost_cast_range_scepter"	"SCEPTER CAST RANGE:"਍∀䜀愀洀攀唀䤀开匀攀爀瘀攀爀刀攀樀攀挀琀䴀甀猀琀唀猀攀䴀愀琀挀栀洀愀欀椀渀最∀ऀ∀䔀猀琀攀 猀攀爀瘀椀搀漀爀 猀漀氀漀 愀挀攀瀀琀愀 挀漀渀攀砀椀漀渀攀猀 最攀猀琀椀漀渀愀搀愀猀 愀 琀爀愀瘀猀 搀攀 洀愀琀挀栀洀愀欀椀渀最⸀ 一漀 猀攀 瀀攀爀洀椀琀攀渀 氀愀猀 挀漀渀攀砀椀漀渀攀猀 愀搀ⴀ栀漀挀尀渀∀ഀഀ
"[english]GameUI_ServerRejectMustUseMatchmaking"	"This server only accepts connections negotiated through matchmaking.  Ad-hoc connections are not allowed\n"਍∀䜀愀洀攀唀䤀开瘀漀琀攀开昀愀椀氀攀搀开挀愀渀渀漀琀开欀椀挀欀开昀漀爀开琀椀洀攀∀ऀ∀一漀 猀攀 瀀甀攀搀攀 攀砀瀀甀氀猀愀爀 愀 攀猀琀攀 樀甀最愀搀漀爀 栀愀猀琀愀 瀀愀猀愀搀漀猀 ─猀㄀ 猀攀最甀渀搀漀猀⸀∀ഀഀ
"[english]GameUI_vote_failed_cannot_kick_for_time"	"This player cannot be kicked for %s1 more seconds."਍∀䜀愀洀攀唀䤀开瘀漀琀攀开昀愀椀氀攀搀开爀漀甀渀搀开愀挀琀椀瘀攀∀ऀ∀䰀漀猀 樀甀最愀搀漀爀攀猀 渀漀 瀀甀攀搀攀渀 猀攀爀 攀砀瀀甀氀猀愀搀漀猀 洀椀攀渀琀爀愀猀 搀甀爀攀 氀愀 爀漀渀搀愀⸀∀ഀഀ
"[english]GameUI_vote_failed_round_active"	"Players cannot be kicked while round is active."਍∀䜀愀洀攀唀䤀开匀攀爀瘀攀爀刀攀焀甀椀爀攀匀琀攀愀洀∀ऀ∀䔀猀琀攀 猀攀爀瘀椀搀漀爀 爀攀焀甀椀攀爀攀 焀甀攀 琀攀渀最愀猀 椀渀椀挀椀愀搀漀 匀琀攀愀洀⸀尀渀∀ഀഀ
"[english]GameUI_ServerRequireSteam"	"The server requires that you be running Steam.\n"਍∀䜀愀洀攀唀䤀开䄀氀氀开䤀洀愀最攀猀一漀䈀洀瀀∀ऀ∀吀漀搀愀猀 氀愀猀 椀洀最攀渀攀猀 ⠀⨀⸀樀瀀最Ⰰ⨀⸀琀最愀Ⰰ⨀⸀瘀琀昀⤀∀ഀഀ
"[english]GameUI_All_ImagesNoBmp"	"All Images (*.jpg,*.tga,*.vtf)"਍∀䜀愀洀攀唀䤀开䐀漀眀渀氀漀愀搀䘀椀氀琀攀爀开䴀愀瀀猀伀渀氀礀∀ऀ∀䄀搀洀椀琀椀爀 猀漀氀漀 氀漀猀 愀爀挀栀椀瘀漀猀 搀攀 洀愀瀀愀∀ഀഀ
"[english]GameUI_DownloadFilter_MapsOnly"	"Only allow map files"਍∀䜀愀洀攀唀䤀开䜀愀洀攀䴀攀渀甀开䄀挀琀椀瘀愀琀攀嘀刀∀ऀ∀䄀䌀吀䤀嘀䄀刀 刀䔀䄀䰀䤀䐀䄀䐀 嘀䤀刀吀唀䄀䰀∀ഀഀ
"[english]GameUI_GameMenu_ActivateVR"	"ACTIVATE VIRTUAL REALITY"਍∀䜀愀洀攀唀䤀开䜀愀洀攀䴀攀渀甀开䐀攀愀挀琀椀瘀愀琀攀嘀刀∀ऀ∀䐀䔀匀䄀䌀吀䤀嘀䄀刀 刀䔀䄀䰀䤀䐀䄀䐀 嘀䤀刀吀唀䄀䰀∀ഀഀ
"[english]GameUI_GameMenu_DeactivateVR"	"DEACTIVATE VIRTUAL REALITY"਍∀䜀愀洀攀唀䤀开嘀刀䴀漀搀攀∀ऀ∀䴀漀搀漀 搀攀 爀攀愀氀椀搀愀搀 瘀椀爀琀甀愀氀∀ഀഀ
"[english]GameUI_VRMode"	"Virtual Reality Mode"਍∀䜀愀洀攀唀䤀开嘀刀䴀漀搀攀刀攀氀愀甀渀挀栀䴀猀最∀ऀ∀䄀挀琀椀瘀愀爀 漀 搀攀猀愀挀琀椀瘀愀爀 攀氀 洀漀搀漀 搀攀 爀攀愀氀椀搀愀搀 瘀椀爀琀甀愀氀 渀漀 琀攀渀搀爀 攀昀攀挀琀漀 栀愀猀琀愀 焀甀攀 爀攀椀渀椀挀椀攀猀 攀氀 樀甀攀最漀⸀∀ഀഀ
"[english]GameUI_VRModeRelaunchMsg"	"Enabling or disabling Virtual Reality Mode will not take effect until you restart the game."਍∀䜀愀洀攀唀䤀开圀椀渀搀漀眀攀搀吀漀漀氀琀椀瀀∀ऀ∀䌀甀愀渀搀漀 攀氀 洀漀搀漀 搀攀 爀攀愀氀椀搀愀搀 瘀椀爀琀甀愀氀 攀猀琀 愀挀琀椀瘀愀搀漀Ⰰ 攀氀 樀甀攀最漀 猀攀 椀渀椀挀椀愀爀 攀渀 洀漀搀漀 瘀攀渀琀愀渀愀 攀渀 氀愀 瀀愀渀琀愀氀氀愀 瀀爀椀渀挀椀瀀愀氀⸀ 匀攀氀攀挀挀椀漀渀愀 愀挀琀椀瘀愀爀 爀攀愀氀椀搀愀搀 瘀椀爀琀甀愀氀 瀀愀爀愀 愀挀琀椀瘀愀爀氀愀⸀∀ഀഀ
"[english]GameUI_WindowedTooltip"	"When VR mode is enabled the game will start windowed on the main display. Select Activate Virtual Reality to switch to VR."਍∀䜀愀洀攀唀䤀开一漀嘀刀吀漀漀氀琀椀瀀∀ऀ∀一漀 猀攀 栀愀 搀攀琀攀挀琀愀搀漀 渀椀渀最甀渀愀 瀀愀渀琀愀氀氀愀⸀ 䌀漀渀攀挀琀愀 琀甀 瀀愀渀琀愀氀氀愀 挀漀洀瀀愀琀椀戀氀攀 挀漀渀 爀攀愀氀椀搀愀搀 瘀椀爀琀甀愀氀 礀 爀攀椀渀椀挀椀愀 攀氀 樀甀攀最漀 瀀愀爀愀 愀挀琀椀瘀愀爀 攀氀 洀漀搀漀 搀攀 爀攀愀氀椀搀愀搀 瘀椀爀琀甀愀氀⸀∀ഀഀ
"[english]GameUI_NoVRTooltip"	"No display detected. Connect your compatible VR display and restart the game to enable VR mode."਍∀䜀愀洀攀唀䤀开䠀䐀䌀漀渀琀攀渀琀∀ऀ∀䌀愀爀最愀爀 挀漀渀琀攀渀椀搀漀 䠀䐀 猀椀 攀猀琀 搀椀猀瀀漀渀椀戀氀攀∀ഀഀ
"[english]GameUI_HDContent"	"Load HD content if available"਍∀䜀愀洀攀唀䤀开䠀䐀刀攀猀琀愀爀琀刀攀焀甀椀爀攀搀开䤀渀昀漀∀ऀ∀倀愀爀愀 瀀漀搀攀爀 愀瀀氀椀挀愀爀 攀猀琀漀猀 挀愀洀戀椀漀猀Ⰰ 琀攀渀搀爀猀 焀甀攀 爀攀椀渀椀挀椀愀爀 攀氀 樀甀攀最漀⸀∀ഀഀ
"[english]GameUI_HDRestartRequired_Info"	"The changes you have made require the game to be restarted to take effect."਍∀䜀愀洀攀唀䤀开倀漀爀琀愀氀䐀攀瀀琀栀㐀∀ऀ∀㐀∀ഀഀ
"[english]GameUI_PortalDepth4"	"4"਍∀䜀愀洀攀唀䤀开䤀挀漀渀猀开䈀䄀䌀䬀∀ऀ∀㐀∀ഀഀ
"[english]GameUI_Icons_BACK"	"4"਍∀䜀愀洀攀唀䤀开瘀漀琀攀开昀愀椀氀攀搀开渀攀砀琀氀攀瘀攀氀开猀攀琀∀ऀ∀夀愀 猀攀 栀愀 攀猀琀愀戀氀攀挀椀搀漀 攀氀 猀椀最甀椀攀渀琀攀 渀椀瘀攀氀⸀∀ഀഀ
"[english]GameUI_vote_failed_nextlevel_set"	"The next level has already been set."਍∀䜀愀洀攀唀䤀开䰀愀渀最甀愀最攀开䌀稀攀挀栀∀ऀ∀䌀栀攀挀漀∀ഀഀ
"[english]GameUI_Language_Czech"	"Czech"਍∀䜀愀洀攀唀䤀开䰀愀渀最甀愀最攀开䈀爀愀稀椀氀椀愀渀∀ऀ∀倀漀爀琀甀最甀猀 搀攀 䈀爀愀猀椀氀∀ഀഀ
"[english]GameUI_Language_Brazilian"	"Portuguese-Brazil"਍∀䜀愀洀攀唀䤀开䰀愀渀最甀愀最攀开䈀甀氀最愀爀椀愀渀∀ऀ∀䈀切氀最愀爀漀∀ഀഀ
"[english]GameUI_Language_Bulgarian"	"Bulgarian"਍∀䜀愀洀攀唀䤀开䰀愀渀最甀愀最攀开䜀爀攀攀欀∀ऀ∀䜀爀椀攀最漀∀ഀഀ
"[english]GameUI_Language_Greek"	"Greek"਍∀䜀愀洀攀唀䤀开䰀愀渀最甀愀最攀开唀欀爀愀椀渀椀愀渀∀ऀ∀唀挀爀愀渀椀愀渀漀∀ഀഀ
"[english]GameUI_Language_Ukrainian"	"Ukrainian"਍∀䜀愀洀攀唀䤀开嘀漀琀攀开一漀琀椀昀椀挀愀琀椀漀渀开吀椀琀氀攀∀ऀ∀嘀漀琀愀挀椀渀 猀漀氀椀挀椀琀愀搀愀∀ഀഀ
"[english]GameUI_Vote_Notification_Title"	"Vote Called"਍∀䜀愀洀攀唀䤀开嘀漀琀攀开一漀琀椀昀椀挀愀琀椀漀渀开吀攀砀琀∀ऀ∀̀─椀渀椀琀椀愀琀漀爀─ 焀甀椀攀爀攀 猀漀氀椀挀椀琀愀爀 甀渀愀 瘀漀琀愀挀椀渀∀ഀഀ
"[english]GameUI_Vote_Notification_Text"	"%initiator% wants to call a vote"਍∀䜀愀洀攀唀䤀开嘀漀琀攀开一漀琀椀昀椀挀愀琀椀漀渀开嘀椀攀眀∀ऀ∀嘀攀爀∀ഀഀ
"[english]GameUI_Vote_Notification_View"	"View"਍∀䜀愀洀攀唀䤀开嘀漀琀攀开匀礀猀琀攀洀开䐀椀猀愀戀氀攀搀∀ऀ∀匀椀猀琀攀洀愀 搀攀 瘀漀琀愀挀椀渀 搀攀猀愀挀琀椀瘀愀搀漀∀ഀഀ
"[english]GameUI_Vote_System_Disabled"	"Vote System Disabled"਍∀䜀愀洀攀唀䤀开嘀漀琀攀开䐀椀猀愀戀氀攀搀∀ऀ∀ ⠀䐀攀猀愀挀琀椀瘀愀搀愀⤀∀ഀഀ
"[english]GameUI_Vote_Disabled"	" (Disabled)"਍∀䜀愀洀攀唀䤀开嘀漀琀攀开吀礀瀀攀∀ऀ∀一漀洀戀爀攀 愀氀琀攀爀渀愀琀椀瘀漀∀ഀഀ
"[english]GameUI_Vote_Type"	"Placeholder Name"਍∀䜀愀洀攀唀䤀开瘀漀琀攀开昀愀椀氀攀搀开瘀漀琀攀开猀瀀愀洀开洀椀渀∀ऀ∀䠀愀猀 猀漀氀椀挀椀琀愀搀漀 甀渀愀 瘀漀琀愀挀椀渀 爀攀挀椀攀渀琀攀洀攀渀琀攀 礀 渀漀 瀀甀攀搀攀猀 猀漀氀椀挀椀琀愀爀 漀琀爀愀 栀愀猀琀愀 搀攀渀琀爀漀 搀攀 ─猀㄀ 洀椀渀甀琀漀⸀∀ഀഀ
"[english]GameUI_vote_failed_vote_spam_min"	"You called a vote recently and can not call another for %s1 minute."਍∀䜀愀洀攀唀䤀开瘀漀琀攀开昀愀椀氀攀搀开瘀漀琀攀开猀瀀愀洀开洀椀渀猀∀ऀ∀䠀愀猀 猀漀氀椀挀椀琀愀搀漀 甀渀愀 瘀漀琀愀挀椀渀 爀攀挀椀攀渀琀攀洀攀渀琀攀 礀 渀漀 瀀甀攀搀攀猀 猀漀氀椀挀椀琀愀爀 漀琀爀愀 栀愀猀琀愀 搀攀渀琀爀漀 搀攀 ─猀㄀ 洀椀渀甀琀漀猀⸀∀ഀഀ
"[english]GameUI_vote_failed_vote_spam_mins"	"You called a vote recently and can not call another for %s1 minutes."਍∀䜀愀洀攀唀䤀开瘀漀琀攀开昀愀椀氀攀搀开爀攀挀攀渀琀氀礀开洀椀渀∀ऀ∀䔀猀琀愀 瘀漀琀愀挀椀渀 礀愀 栀愀 猀椀搀漀 猀漀氀椀挀椀琀愀搀愀 爀攀挀椀攀渀琀攀洀攀渀琀攀 礀 渀漀 瀀甀攀搀攀 猀漀氀椀挀椀琀愀爀猀攀 搀攀 渀甀攀瘀漀 栀愀猀琀愀 搀攀渀琀爀漀 搀攀 ─猀㄀ 洀椀渀甀琀漀⸀∀ഀഀ
"[english]GameUI_vote_failed_recently_min"	"This vote was called recently and cannot be called again for %s1 minute."਍∀䜀愀洀攀唀䤀开瘀漀琀攀开昀愀椀氀攀搀开爀攀挀攀渀琀氀礀开洀椀渀猀∀ऀ∀䔀猀琀愀 瘀漀琀愀挀椀渀 礀愀 栀愀 猀椀搀漀 猀漀氀椀挀椀琀愀搀愀 爀攀挀椀攀渀琀攀洀攀渀琀攀 礀 渀漀 瀀甀攀搀攀 猀漀氀椀挀椀琀愀爀猀攀 搀攀 渀甀攀瘀漀 栀愀猀琀愀 搀攀渀琀爀漀 搀攀 ─猀㄀ 洀椀渀甀琀漀猀⸀∀ഀഀ
"[english]GameUI_vote_failed_recently_mins"	"This vote was called recently and cannot be called again for %s1 minutes."਍∀䜀愀洀攀唀䤀开瘀漀琀攀开昀愀椀氀攀搀开挀愀渀渀漀琀开欀椀挀欀∀ऀ∀一漀 猀攀 瀀甀攀搀攀 攀砀瀀甀氀猀愀爀 愀 攀猀琀攀 樀甀最愀搀漀爀 栀愀猀琀愀 瀀愀猀愀搀漀猀 ─猀㄀ 猀攀最甀渀搀漀猀⸀∀ഀഀ
"[english]GameUI_vote_failed_cannot_kick"	"This player cannot be kicked for %s1 more seconds."਍∀䜀愀洀攀唀䤀开瘀漀琀攀开昀愀椀氀攀搀开挀愀渀渀漀琀开欀椀挀欀开洀椀渀∀ऀ∀一漀 猀攀 瀀甀攀搀攀 攀砀瀀甀氀猀愀爀 愀 攀猀琀攀 樀甀最愀搀漀爀 栀愀猀琀愀 瀀愀猀愀搀漀 ─猀㄀ 洀椀渀甀琀漀⸀∀ഀഀ
"[english]GameUI_vote_failed_cannot_kick_min"	"This player cannot be kicked for %s1 more minute."਍∀䜀愀洀攀唀䤀开瘀漀琀攀开昀愀椀氀攀搀开挀愀渀渀漀琀开欀椀挀欀开洀椀渀猀∀ऀ∀一漀 猀攀 瀀甀攀搀攀 攀砀瀀甀氀猀愀爀 愀 攀猀琀攀 樀甀最愀搀漀爀 栀愀猀琀愀 瀀愀猀愀搀漀猀 ─猀㄀ 洀椀渀甀琀漀猀⸀∀ഀഀ
"[english]GameUI_vote_failed_cannot_kick_mins"	"This player cannot be kicked for %s1 more minutes."਍∀䜀愀洀攀唀䤀开瘀漀琀攀开昀愀椀氀攀搀开瘀漀琀攀开椀渀开瀀爀漀最爀攀猀猀∀ऀ∀唀渀愀 瘀漀琀愀挀椀渀 猀攀 攀渀挀甀攀渀琀爀愀 愀挀琀甀愀氀洀攀渀琀攀 攀渀 挀甀爀猀漀⸀∀ഀഀ
"[english]GameUI_vote_failed_vote_in_progress"	"A vote is currently in progress."਍∀䜀愀洀攀唀䤀开瘀漀琀攀开礀攀猀开猀挀开椀渀猀琀爀甀挀琀椀漀渀∀ऀ∀倀甀氀猀愀 ─挀氀开琀爀椀最最攀爀开昀椀爀猀琀开渀漀琀椀昀椀挀愀琀椀漀渀─ 瀀愀爀愀 瘀漀琀愀爀 匀촀∀ഀഀ
"[english]GameUI_vote_yes_sc_instruction"	"Press %cl_trigger_first_notification% to vote YES"਍∀䜀愀洀攀唀䤀开瘀漀琀攀开渀漀开猀挀开椀渀猀琀爀甀挀琀椀漀渀∀ऀ∀倀甀氀猀愀 ─挀氀开搀攀挀氀椀渀攀开昀椀爀猀琀开渀漀琀椀昀椀挀愀琀椀漀渀─ 瀀愀爀愀 瘀漀琀愀爀 一伀∀ഀഀ
"[english]GameUI_vote_no_sc_instruction"	"Press %cl_decline_first_notification% to vote NO"਍∀䜀愀洀攀唀䤀开瘀漀琀攀开昀愀椀氀攀搀开欀椀挀欀开氀椀洀椀琀开最挀∀ऀ∀䠀愀猀 愀氀挀愀渀稀愀搀漀 攀氀 氀洀椀琀攀 搀攀 瘀漀琀漀猀 瀀愀爀愀 攀砀瀀甀氀猀愀爀 攀渀 䴀愀渀渀 挀漀渀琀爀愀 䴀焀甀椀渀愀猀⸀∀ഀഀ
"[english]GameUI_vote_failed_kick_limit_gc"	"You have reached your limit of kick votes in Mann-Vs-Machine."਍∀䜀愀洀攀唀䤀开刀攀瀀漀爀琀倀氀愀礀攀爀∀ऀ∀䐀攀渀甀渀挀椀愀爀 樀甀最愀搀漀爀∀ഀഀ
"[english]GameUI_ReportPlayer"	"Report Player"਍∀䜀愀洀攀唀䤀开刀攀瀀漀爀琀倀氀愀礀攀爀䌀愀瀀猀∀ऀ∀䐀䔀一唀一䌀䤀䄀刀 䨀唀䜀䄀䐀伀刀∀ഀഀ
"[english]GameUI_ReportPlayerCaps"	"REPORT PLAYER"਍∀䜀愀洀攀唀䤀开刀攀瀀漀爀琀倀氀愀礀攀爀刀攀愀猀漀渀∀ऀ∀䴀漀琀椀瘀漀㨀∀ഀഀ
"[english]GameUI_ReportPlayerReason"	"Reason:"਍∀䜀愀洀攀唀䤀开刀攀瀀漀爀琀倀氀愀礀攀爀开䌀栀漀漀猀攀∀ऀ∀ⴀⴀ䔀氀椀最攀 甀渀 洀漀琀椀瘀漀ⴀⴀ∀ഀഀ
"[english]GameUI_ReportPlayer_Choose"	"--Choose Reason--"਍∀䜀愀洀攀唀䤀开刀攀瀀漀爀琀倀氀愀礀攀爀开䌀栀攀愀琀椀渀最∀ऀ∀䠀愀挀攀 琀爀愀洀瀀愀猀∀ഀഀ
"[english]GameUI_ReportPlayer_Cheating"	"Cheating"਍∀䜀愀洀攀唀䤀开刀攀瀀漀爀琀倀氀愀礀攀爀开䤀搀氀攀∀ऀ∀䤀渀愀挀琀椀瘀漀⼀䄀甀猀攀渀琀攀∀ഀഀ
"[english]GameUI_ReportPlayer_Idle"	"Idle/AFK"਍∀䜀愀洀攀唀䤀开刀攀瀀漀爀琀倀氀愀礀攀爀开䠀愀爀愀猀猀洀攀渀琀∀ऀ∀䄀挀漀猀漀∀ഀഀ
"[english]GameUI_ReportPlayer_Harassment"	"Harassment"਍∀䜀愀洀攀唀䤀开刀攀瀀漀爀琀倀氀愀礀攀爀开䜀爀椀攀昀椀渀最∀ऀ∀䌀漀渀搀甀挀琀愀 洀漀氀攀猀琀愀∀ഀഀ
"[english]GameUI_ReportPlayer_Griefing"	"Griefing"਍∀䜀愀洀攀唀䤀开倀愀甀猀攀搀吀椀洀攀爀∀ऀ∀䔀一 倀䄀唀匀䄀 ⴀ ─猀㄀∀ഀഀ
"[english]GameUI_PausedTimer"	"PAUSED - %s1"਍紀ഀഀ
}਍
