"lang"਍笀ഀഀ
"Language"	"latam"਍∀吀漀欀攀渀猀∀ഀഀ
{਍∀䠀吀吀倀䔀爀爀漀爀开娀攀爀漀䰀攀渀最琀栀䘀椀氀攀∀ऀ∀䄀爀挀栀椀瘀漀 搀攀 氀漀渀最椀琀甀搀 挀攀爀漀∀ഀഀ
"[english]HTTPError_ZeroLengthFile"	"Zero length file"਍∀䠀吀吀倀䔀爀爀漀爀开䌀漀渀渀攀挀琀椀漀渀䌀氀漀猀攀搀∀ऀ∀䌀漀渀攀砀椀渀 挀攀爀爀愀搀愀∀ഀഀ
"[english]HTTPError_ConnectionClosed"	"Connection closed"਍∀䠀吀吀倀䔀爀爀漀爀开䤀渀瘀愀氀椀搀唀刀䰀∀ऀ∀唀刀䰀 渀漀 瘀氀椀搀愀∀ഀഀ
"[english]HTTPError_InvalidURL"	"Invalid URL"਍∀䠀吀吀倀䔀爀爀漀爀开䤀渀瘀愀氀椀搀倀爀漀琀漀挀漀氀∀ऀ∀倀爀漀琀漀挀漀氀漀 渀漀 瘀氀椀搀漀∀ഀഀ
"[english]HTTPError_InvalidProtocol"	"Invalid protocol"਍∀䠀吀吀倀䔀爀爀漀爀开䌀愀渀琀䈀椀渀搀匀漀挀欀攀琀∀ऀ∀一漀 猀攀 瀀甀搀漀 愀猀漀挀椀愀爀 攀氀 猀漀挀欀攀琀∀ഀഀ
"[english]HTTPError_CantBindSocket"	"Couldn't bind socket"਍∀䠀吀吀倀䔀爀爀漀爀开䌀愀渀琀䌀漀渀渀攀挀琀∀ऀ∀一漀 猀攀 栀愀 瀀漀搀椀搀漀 攀猀琀愀戀氀攀挀攀爀 挀漀渀攀砀椀渀∀ഀഀ
"[english]HTTPError_CantConnect"	"Couldn't connect"਍∀䠀吀吀倀䔀爀爀漀爀开一漀䠀攀愀搀攀爀猀∀ऀ∀一漀 栀愀礀 攀渀挀愀戀攀稀愀洀椀攀渀琀漀猀∀ഀഀ
"[english]HTTPError_NoHeaders"	"No headers"਍∀䠀吀吀倀䔀爀爀漀爀开一漀渀䔀砀椀猀琀攀渀琀∀ऀ∀䄀爀挀栀椀瘀漀 椀渀攀砀椀猀琀攀渀琀攀∀ഀഀ
"[english]HTTPError_NonExistent"	"Non-existent file"਍∀䠀吀吀倀䔀爀爀漀爀开唀渀欀渀漀眀渀∀ऀ∀䔀爀爀漀爀 搀攀猀挀漀渀漀挀椀搀漀∀ഀഀ
"[english]HTTPError_Unknown"	"Unknown error"਍∀刀攀瀀氀愀礀开匀愀瘀攀刀攀瀀氀愀礀∀ऀ∀䜀甀愀爀搀愀爀 最爀愀戀愀挀椀渀 搀攀 琀甀 瘀椀搀愀 愀挀琀甀愀氀 漀 愀渀琀攀爀椀漀爀∀ഀഀ
"[english]Replay_SaveReplay"	"Save a replay of your current or last life"਍∀刀攀瀀氀愀礀开昀爀攀攀稀攀挀愀洀开爀攀瀀氀愀礀∀ऀ∀嬀─猀㄀崀 ꄀ䌀爀攀愀爀 甀渀愀 最爀愀戀愀挀椀渀℀∀ഀഀ
"[english]Replay_freezecam_replay"	"[%s1] Create a replay!"਍∀刀攀瀀氀愀礀开匀愀瘀椀渀最∀ऀ∀䜀甀愀爀搀愀渀搀漀∀ഀഀ
"[english]Replay_Saving"	"Saving"਍∀刀攀瀀氀愀礀开夀攀猀∀ऀ∀匀∀ഀഀ
"[english]Replay_Yes"	"Yes"਍∀刀攀瀀氀愀礀开一漀∀ऀ∀一漀∀ഀഀ
"[english]Replay_No"	"No"਍∀刀攀瀀氀愀礀开䐀漀眀渀氀漀愀搀∀ऀ∀䐀攀猀挀愀爀最愀爀∀ഀഀ
"[english]Replay_Download"	"Download"਍∀刀攀瀀氀愀礀开䐀攀氀攀琀攀∀ऀ∀䔀氀椀洀椀渀愀爀∀ഀഀ
"[english]Replay_Delete"	"Delete"਍∀刀攀瀀氀愀礀开匀愀瘀攀∀ऀ∀䜀甀愀爀搀愀爀∀ഀഀ
"[english]Replay_Save"	"Save"਍∀刀攀瀀氀愀礀开一愀洀攀夀漀甀爀刀攀瀀氀愀礀∀ऀ∀一伀䴀䈀刀䔀 䐀䔀 吀唀 䜀刀䄀䈀䄀䌀䤀팀一∀ഀഀ
"[english]Replay_NameYourReplay"	"NAME YOUR REPLAY"਍∀刀攀瀀氀愀礀开唀渀琀椀琀氀攀搀∀ऀ∀匀椀渀 琀琀甀氀漀 ─猀㄀∀ഀഀ
"[english]Replay_Untitled"	"Untitled %s1"਍∀刀攀瀀氀愀礀开䔀渀琀攀爀夀漀甀爀一愀洀攀∀ऀ∀䤀渀琀爀漀搀甀挀攀 甀渀 渀漀洀戀爀攀 愀焀甀 瀀愀爀愀 椀搀攀渀琀椀昀椀挀愀爀 攀猀琀愀 最爀愀戀愀挀椀渀 洀猀 琀愀爀搀攀⸀∀ഀഀ
"[english]Replay_EnterYourName"	"Enter a name here to help you identify this Replay later."਍∀刀攀瀀氀愀礀开匀琀愀爀琀䐀漀眀渀氀漀愀搀䄀甀琀漀∀ऀ∀䔀洀瀀攀稀愀爀 氀愀 搀攀猀挀愀爀最愀 愀甀琀漀洀琀椀挀愀洀攀渀琀攀 挀甀愀渀搀漀 攀氀 愀爀挀栀椀瘀漀 搀攀 最爀愀戀愀挀椀渀 攀猀琀 搀椀猀瀀漀渀椀戀氀攀 攀渀 攀氀 猀攀爀瘀椀搀漀爀⸀∀ഀഀ
"[english]Replay_StartDownloadAuto"	"Start download automatically when Replay file is available on server."਍∀刀攀瀀氀愀礀开一攀瘀攀爀匀栀漀眀䄀最愀椀渀∀ऀ∀一漀 瘀漀氀瘀攀爀 愀 洀漀猀琀爀愀爀 攀猀琀漀⸀∀ഀഀ
"[english]Replay_NeverShowAgain"	"Never show this again!"਍∀刀攀瀀氀愀礀开一愀洀攀夀漀甀爀吀愀欀攀∀ऀ∀一伀䴀䈀刀䔀 䐀䔀 吀唀 吀伀䴀䄀∀ഀഀ
"[english]Replay_NameYourTake"	"NAME YOUR TAKE"਍∀刀攀瀀氀愀礀开一愀洀攀䘀椀渀攀倀爀椀渀琀∀ऀ∀䤀渀琀爀漀搀甀挀攀 甀渀 渀漀洀戀爀攀 愀焀甀 瀀愀爀愀 椀搀攀渀琀椀昀椀挀愀爀 攀猀琀愀 琀漀洀愀 洀猀 琀愀爀搀攀⸀∀ഀഀ
"[english]Replay_NameFinePrint"	"Enter a name here to help you identify this take later."਍∀刀攀瀀氀愀礀开䐀椀猀挀愀爀搀∀ऀ∀堀 䐀䔀匀䌀䄀刀吀䄀刀∀ഀഀ
"[english]Replay_Discard"	"X DISCARD"਍∀刀攀瀀氀愀礀开匀愀瘀攀倀攀爀昀漀爀洀愀渀挀攀∀ऀ∀䜀唀䄀刀䐀䄀刀∀ഀഀ
"[english]Replay_SavePerformance"	"SAVE"਍∀刀攀瀀氀愀礀开䜀漀琀漀吀椀挀欀吀椀琀氀攀∀ऀ∀䤀爀 愀∀ഀഀ
"[english]Replay_GotoTickTitle"	"Jump to Time"਍∀刀攀瀀氀愀礀开䜀漀琀漀吀椀挀欀刀攀眀椀渀搀吀攀砀琀∀ऀ∀뼀刀攀琀爀漀挀攀搀攀爀 栀愀猀琀愀 ─琀椀洀攀─㼀 䰀愀 最爀愀戀愀挀椀渀 琀愀爀搀愀爀 甀渀 洀漀洀攀渀琀漀 攀渀 爀攀戀漀戀椀渀愀爀猀攀⸀∀ഀഀ
"[english]Replay_GotoTickRewindText"	"Jump back to %time%? It will take a moment to rewind the replay."਍∀刀攀瀀氀愀礀开䜀漀琀漀吀椀挀欀䘀愀猀琀䘀漀爀眀愀爀搀吀攀砀琀∀ऀ∀뼀䄀瘀愀渀稀愀爀 栀愀猀琀愀 ─琀椀洀攀─㼀∀ഀഀ
"[english]Replay_GotoTickFastForwardText"	"Jump forward to %time%?"਍∀刀攀瀀氀愀礀开䐀椀猀挀愀爀搀吀椀琀氀攀∀ऀ∀뼀䐀攀猀挀愀爀琀愀爀 挀愀洀戀椀漀猀㼀∀ഀഀ
"[english]Replay_DiscardTitle"	"Discard changes?"਍∀刀攀瀀氀愀礀开䐀椀猀挀愀爀搀䌀栀愀渀最攀猀∀ऀ∀䠀愀礀 挀愀洀戀椀漀猀 猀椀渀 最甀愀爀搀愀爀⸀ 뼀䐀攀猀挀愀爀琀愀爀㼀尀渀尀渀一伀吀䄀㨀 倀甀攀搀攀猀 最甀愀爀搀愀爀 瀀甀氀猀愀渀搀漀 攀氀 戀漀琀渀 搀攀氀 洀攀渀切 攀渀 氀愀 攀猀焀甀椀渀愀 猀甀瀀攀爀椀漀爀 椀稀焀甀椀攀爀搀愀 礀 猀攀氀攀挀挀椀漀渀愀渀搀漀 䜀唀䄀刀䐀䄀刀 漀 䜀唀䄀刀䐀䄀刀 䌀伀䴀伀⸀∀ഀഀ
"[english]Replay_DiscardChanges"	"You have unsaved changes.  Discard?\n\nNOTE: You can save by clicking the menu button in the top left and selecting SAVE or SAVE AS."਍∀刀攀瀀氀愀礀开䔀砀椀琀䔀搀椀琀漀爀吀椀琀氀攀∀ऀ∀뼀䠀愀猀 愀挀愀戀愀搀漀㼀∀ഀഀ
"[english]Replay_ExitEditorTitle"	"DONE?"਍∀刀攀瀀氀愀礀开䈀愀挀欀吀漀刀攀瀀氀愀礀猀∀ऀ∀䔀猀琀漀 琀攀 氀氀攀瘀愀爀 搀攀 瘀甀攀氀琀愀 愀 琀甀猀 最爀愀戀愀挀椀漀渀攀猀⸀∀ഀഀ
"[english]Replay_BackToReplays"	"This will take you back to your replays."਍∀刀攀瀀氀愀礀䈀爀漀眀猀攀爀䐀氀最开䐀漀眀渀氀漀愀搀攀搀∀ऀ∀䐀攀猀挀愀爀最愀搀漀∀ഀഀ
"[english]ReplayBrowserDlg_Downloaded"	"Downloaded"਍∀刀攀瀀氀愀礀䈀爀漀眀猀攀爀䐀氀最开刀攀渀搀攀爀攀搀∀ऀ∀刀攀渀搀攀爀椀稀愀搀漀∀ഀഀ
"[english]ReplayBrowserDlg_Rendered"	"Rendered"਍∀刀攀瀀氀愀礀䈀爀漀眀猀攀爀䐀氀最开䐀攀氀攀琀椀漀渀∀ऀ∀吀椀攀洀瀀漀 刀攀猀琀愀渀琀攀∀ഀഀ
"[english]ReplayBrowserDlg_Deletion"	"Time Remaining"਍∀刀攀瀀氀愀礀䈀爀漀眀猀攀爀䐀氀最开䘀椀氀攀渀愀洀攀∀ऀ∀一漀洀戀爀攀 搀攀 愀爀挀栀椀瘀漀∀ഀഀ
"[english]ReplayBrowserDlg_Filename"	"Filename"਍∀刀攀瀀氀愀礀䈀爀漀眀猀攀爀䐀氀最开䴀愀瀀∀ऀ∀䴀愀瀀愀∀ഀഀ
"[english]ReplayBrowserDlg_Map"	"Map"਍∀刀攀瀀氀愀礀䈀爀漀眀猀攀爀䐀氀最开匀攀爀瘀攀爀∀ऀ∀匀攀爀瘀椀搀漀爀∀ഀഀ
"[english]ReplayBrowserDlg_Server"	"Server"਍∀刀攀瀀氀愀礀䈀爀漀眀猀攀爀䐀氀最开刀攀挀漀爀搀吀椀洀攀∀ऀ∀䜀爀愀戀愀搀漀∀ഀഀ
"[english]ReplayBrowserDlg_RecordTime"	"Recorded"਍∀刀攀瀀氀愀礀䈀爀漀眀猀攀爀䐀氀最开䰀攀渀最琀栀∀ऀ∀䐀甀爀愀挀椀渀∀ഀഀ
"[english]ReplayBrowserDlg_Length"	"Length"਍∀刀攀瀀氀愀礀䈀爀漀眀猀攀爀䐀氀最开匀椀稀攀∀ऀ∀吀愀洀愀漀 ⠀䴀䈀⤀∀ഀഀ
"[english]ReplayBrowserDlg_Size"	"Size (MB)"਍∀刀攀瀀氀愀礀䈀爀漀眀猀攀爀䐀氀最开一漀䐀攀洀漀猀∀ऀ∀一漀 栀愀礀 搀攀洀漀猀 焀甀攀 爀攀瀀爀漀搀甀挀椀爀⸀∀ഀഀ
"[english]ReplayBrowserDlg_NoDemos"	"No demos to display."਍∀刀攀瀀氀愀礀䈀爀漀眀猀攀爀䐀氀最开匀栀漀眀䄀氀氀∀ऀ∀䴀漀猀琀爀愀爀 吀漀搀愀猀∀ഀഀ
"[english]ReplayBrowserDlg_ShowAll"	"Show All"਍∀刀攀瀀氀愀礀䈀爀漀眀猀攀爀䐀氀最开堀䴀漀爀攀刀攀瀀氀愀礀猀∀ऀ∀ꄀ─猀㄀ 洀猀℀∀ഀഀ
"[english]ReplayBrowserDlg_XMoreReplays"	"%s1 more!"਍∀刀攀瀀氀愀礀开䴀礀刀攀瀀氀愀礀猀∀ऀ∀䜀刀䄀䈀䄀䌀䤀伀一䔀匀∀ഀഀ
"[english]Replay_MyReplays"	"REPLAYS"਍∀刀攀瀀氀愀礀开刀攀瀀氀愀礀∀ऀ∀䜀刀䄀䈀䄀䌀䤀伀一䔀匀∀ഀഀ
"[english]Replay_Replay"	"REPLAYS"਍∀刀攀瀀氀愀礀开刀攀瀀氀愀礀䴀猀最吀椀琀氀攀∀ऀ∀䜀刀䄀䈀䄀䌀䤀팀一∀ഀഀ
"[english]Replay_ReplayMsgTitle"	"REPLAY"਍∀刀攀瀀氀愀礀开䌀漀渀渀攀挀琀椀渀最∀ऀ∀䌀伀一䔀䌀吀䄀一䐀伀∀ഀഀ
"[english]Replay_Connecting"	"CONNECTING"਍∀刀攀瀀氀愀礀开刀攀挀漀爀搀椀渀最䤀渀倀爀漀最爀攀猀猀∀ऀ∀䜀刀䄀䈀䄀䌀䤀팀一 䔀一 䌀唀刀匀伀∀ഀഀ
"[english]Replay_RecordingInProgress"	"RECORDING IN PROGRESS"਍∀刀攀瀀氀愀礀开䔀爀爀漀爀∀ऀ∀䔀刀刀伀刀∀ഀഀ
"[english]Replay_Error"	"ERROR"਍∀刀攀瀀氀愀礀开䌀愀渀琀䔀砀瀀漀爀琀∀ऀ∀一伀 匀䔀 倀唀䔀䐀䔀 䔀堀倀伀刀吀䄀刀∀ഀഀ
"[english]Replay_CantExport"	"CAN'T EXPORT"਍∀刀攀瀀氀愀礀开䌀愀渀琀唀瀀氀漀愀搀∀ऀ∀一伀 匀䔀 倀唀䔀䐀䔀 匀唀䈀䤀刀∀ഀഀ
"[english]Replay_CantUpload"	"CAN'T UPLOAD"਍∀刀攀瀀氀愀礀开䐀漀眀渀氀漀愀搀椀渀最∀ऀ∀䐀䔀匀䌀䄀刀䜀䄀一䐀伀∀ഀഀ
"[english]Replay_Downloading"	"DOWNLOADING"਍∀刀攀瀀氀愀礀开圀愀椀琀椀渀最∀ऀ∀䔀匀倀䔀刀䄀一䐀伀∀ഀഀ
"[english]Replay_Waiting"	"WAITING"਍∀刀攀瀀氀愀礀开唀渀爀攀渀搀攀爀攀搀刀攀瀀氀愀礀猀∀ऀ∀䜀刀䄀䈀䄀䌀䤀伀一䔀匀 吀䔀䴀倀伀刀䄀䰀䔀匀 ⠀─猀㄀⤀ 㨀∀ഀഀ
"[english]Replay_UnrenderedReplays"	"TEMPORARY REPLAYS (%s1) :"਍∀刀攀瀀氀愀礀开匀愀瘀攀搀䴀漀瘀椀攀猀∀ऀ∀嘀촀䐀䔀伀匀 䜀唀䄀刀䐀䄀䐀伀匀 ⠀─猀㄀⤀ 㨀∀ഀഀ
"[english]Replay_SavedMovies"	"SAVED MOVIES (%s1) :"਍∀刀攀瀀氀愀礀开䌀漀渀瘀攀爀猀椀漀渀圀愀爀渀椀渀最∀ऀ∀匀漀渀 琀攀洀瀀漀爀愀氀攀猀 礀Ⰰ 愀 渀漀 猀攀爀 焀甀攀 氀愀猀 最甀愀爀搀攀猀Ⰰ 瀀甀攀搀攀渀 瀀攀爀搀攀爀猀攀 挀漀渀 氀愀 瀀爀砀椀洀愀 愀挀琀甀愀氀椀稀愀挀椀渀⸀∀ഀഀ
"[english]Replay_ConversionWarning"	"These are temporary, and unless saved, may be lost with the next game update."਍∀刀攀瀀氀愀礀开刀攀渀搀攀爀䄀氀氀∀ऀ∀䜀唀䄀刀䐀䄀刀䰀䄀匀∀ഀഀ
"[english]Replay_RenderAll"	"SAVE ALL..."਍∀刀攀瀀氀愀礀开匀琀愀爀琀刀攀挀漀爀搀∀ऀ∀䔀氀 猀攀爀瘀椀搀漀爀 攀猀琀 氀椀猀琀漀 瀀愀爀愀 最爀愀戀愀爀⸀∀ഀഀ
"[english]Replay_StartRecord"	"The server is ready to capture replays."਍∀刀攀瀀氀愀礀开䔀渀搀刀攀挀漀爀搀∀ऀ∀䔀氀 猀攀爀瘀椀搀漀爀 礀愀 渀漀 攀猀琀 最爀愀戀愀渀搀漀⸀ 吀漀搀愀猀 氀愀猀 最爀愀戀愀挀椀漀渀攀猀 最甀愀爀搀愀搀愀猀 攀猀琀渀 氀椀猀琀愀猀 瀀愀爀愀 搀攀猀挀愀爀最愀爀⸀∀ഀഀ
"[english]Replay_EndRecord"	"The server is no longer capturing replays.  Any replays saved are now ready for download."਍∀刀攀瀀氀愀礀开刀攀瀀氀愀礀猀䄀瘀愀椀氀愀戀氀攀∀ऀ∀䰀愀猀 最爀愀戀愀挀椀漀渀攀猀 搀攀 氀愀 爀漀渀搀愀 愀渀琀攀爀椀漀爀 攀猀琀渀 氀椀猀琀愀猀 瀀愀爀愀 搀攀猀挀愀爀最愀爀⸀∀ഀഀ
"[english]Replay_ReplaysAvailable"	"Replays from the previous round are now ready for download."਍∀刀攀瀀氀愀礀开刀攀瀀氀愀礀匀愀瘀攀搀䄀氀椀瘀攀∀ऀ∀吀甀 最爀愀戀愀挀椀渀 攀洀瀀攀稀愀爀 愀 搀攀猀挀愀爀最愀爀猀攀尀渀攀渀 挀甀愀渀琀漀 洀甀攀爀愀猀⸀∀ഀഀ
"[english]Replay_ReplaySavedAlive"	"Your Replay will begin downloading after this life."਍∀刀攀瀀氀愀礀开刀攀瀀氀愀礀匀愀瘀攀搀䐀攀愀搀∀ऀ∀吀甀 最爀愀戀愀挀椀渀 猀攀 栀愀 最甀愀爀搀愀搀漀 礀 攀洀瀀攀稀愀爀 愀 搀攀猀挀愀爀最愀爀猀攀 攀渀 甀渀 洀漀洀攀渀琀漀⸀∀ഀഀ
"[english]Replay_ReplaySavedDead"	"Your Replay has been saved and will begin downloading momentarily."਍∀刀攀瀀氀愀礀开䄀氀爀攀愀搀礀匀愀瘀攀搀∀ऀ∀ꄀ䜀爀愀戀愀挀椀渀 挀爀攀愀搀愀℀ 倀椀渀挀栀愀 攀渀 䜀刀䄀䈀䄀䌀䤀伀一䔀匀 攀渀 攀氀 洀攀渀切 瀀爀椀渀挀椀瀀愀氀 瀀愀爀愀 瘀攀爀氀愀⸀∀ഀഀ
"[english]Replay_AlreadySaved"	"Replay already created!  Click REPLAYS in the main menu to watch it."਍∀刀攀瀀氀愀礀开一漀䰀椀猀琀攀渀匀攀爀瘀攀爀∀ऀ∀䰀愀猀 最爀愀戀愀挀椀漀渀攀猀 渀漀 攀猀琀渀 愀挀琀椀瘀愀搀愀猀 攀渀 猀攀爀瘀椀搀漀爀攀猀 氀漀挀愀氀攀猀⸀∀ഀഀ
"[english]Replay_NoListenServer"	"Replay is not supported on listen servers."਍∀刀攀瀀氀愀礀开一漀琀䔀渀愀戀氀攀搀∀ऀ∀䔀渀 攀猀琀攀 洀漀洀攀渀琀漀Ⰰ 氀愀 最爀愀戀愀挀椀渀 攀猀琀 搀攀猀愀挀琀椀瘀愀搀愀 攀渀 攀猀琀攀 猀攀爀瘀椀搀漀爀⸀∀ഀഀ
"[english]Replay_NotEnabled"	"Replay is currently disabled on this server."਍∀刀攀瀀氀愀礀开一漀琀刀攀挀漀爀搀椀渀最∀ऀ∀䔀氀 猀攀爀瘀椀搀漀爀 渀漀 攀猀琀 最爀愀戀愀渀搀漀 攀渀 攀猀琀攀 洀漀洀攀渀琀漀⸀∀ഀഀ
"[english]Replay_NotRecording"	"The server is not capturing replays right now."਍∀刀攀瀀氀愀礀开䌀漀渀渀攀挀琀刀攀挀漀爀搀椀渀最∀ऀ∀䔀猀琀攀 猀攀爀瘀椀搀漀爀 瀀甀攀搀攀 挀爀攀愀爀 最爀愀戀愀挀椀漀渀攀猀⸀尀渀倀甀氀猀愀 嬀 ─猀㄀ 崀 攀渀 挀甀愀氀焀甀椀攀爀 洀漀洀攀渀琀漀 瀀愀爀愀 挀爀攀愀爀 甀渀愀 最爀愀戀愀挀椀渀 搀攀 琀甀 瘀椀搀愀 愀挀琀甀愀氀⸀尀渀尀渀一漀琀愀㨀 匀椀 猀攀 栀愀挀攀 攀渀 洀漀搀漀 攀猀瀀攀挀琀愀搀漀爀Ⰰ 猀攀 最爀愀戀愀爀 琀甀 瘀椀搀愀 愀渀琀攀爀椀漀爀⸀∀ഀഀ
"[english]Replay_ConnectRecording"	"This server is replay capable.\nPress [ %s1 ] at any time to create a replay for your current life.\n\nNote: If done while spectating, your previous life will be used."਍∀刀攀瀀氀愀礀开刀攀瀀氀愀礀匀愀瘀攀䌀漀渀琀攀砀琀∀ऀ∀倀甀氀猀愀 嬀 ─猀㄀ 崀 攀渀 挀甀愀氀焀甀椀攀爀 洀漀洀攀渀琀漀 瀀愀爀愀 挀爀攀愀爀 甀渀愀 最爀愀戀愀挀椀渀 搀攀 琀甀 瘀椀搀愀 愀挀琀甀愀氀⸀尀渀尀渀一漀琀愀㨀 匀椀 猀攀 栀愀挀攀 攀渀 洀漀搀漀 攀猀瀀攀挀琀愀搀漀爀Ⰰ 猀攀 最爀愀戀愀爀 琀甀 瘀椀搀愀 愀渀琀攀爀椀漀爀⸀∀ഀഀ
"[english]Replay_ReplaySaveContext"	"Press [ %s1 ] at any time to create a replay for that life.  If done while spectating, your previous life will be saved."਍∀刀攀瀀氀愀礀开䠀椀搀攀吀栀椀猀䴀攀猀猀愀最攀∀ऀ∀嬀 ─猀㄀ 崀 瀀愀爀愀 漀挀甀氀琀愀爀 攀猀琀攀 洀攀渀猀愀樀攀∀ഀഀ
"[english]Replay_HideThisMessage"	"[ %s1 ] to hide this message"਍∀刀攀瀀氀愀礀开䐀攀昀愀甀氀琀匀攀爀瘀攀爀䔀爀爀漀爀∀ऀ∀䔀氀 猀攀爀瘀椀搀漀爀 栀愀 攀渀挀漀渀琀爀愀搀漀 甀渀 攀爀爀漀爀 瀀爀漀挀攀猀愀渀搀漀 氀愀猀 最爀愀戀愀挀椀漀渀攀猀 搀攀 氀愀 切氀琀椀洀愀 爀漀渀搀愀⸀∀ഀഀ
"[english]Replay_DefaultServerError"	"The server encountered an error in processing Replays for the last round."਍∀刀攀瀀氀愀礀开一漀刀攀瀀氀愀礀猀∀ऀ∀䄀䌀吀唀䄀䰀䴀䔀一吀䔀 一伀 吀䤀䔀一䔀匀 䜀刀䄀䈀䄀䌀䤀伀一䔀匀⸀尀尀一倀唀䰀匀䄀 嬀 ─匀㄀ 崀 䐀唀刀䄀一吀䔀 唀一䄀 倀䄀刀吀䤀䐀䄀 倀䄀刀䄀 䌀刀䔀䄀刀 唀一䄀⸀∀ഀഀ
"[english]Replay_NoReplays"	"CURRENTLY YOU HAVE NO REPLAYS.\nPRESS [ %s1 ] DURING A GAME TO CREATE ONE."਍∀刀攀瀀氀愀礀开一漀䴀漀瘀椀攀猀∀ऀ∀䄀䌀吀唀䄀䰀䴀䔀一吀䔀 一伀 吀䤀䔀一䔀匀 倀䔀䰀촀䌀唀䰀䄀匀 䜀唀䄀刀䐀䄀䐀䄀匀⸀尀尀一倀唀䔀䐀䔀匀 䌀伀一嘀䔀刀吀䤀刀 䜀刀䄀䈀䄀䌀䤀伀一䔀匀 䔀一 倀䔀䰀촀䌀唀䰀䄀匀 夀 䌀伀䴀倀䄀刀吀䤀刀䰀䄀匀尀尀一䌀伀一 吀唀匀 䄀䴀䤀䜀伀匀⸀∀ഀഀ
"[english]Replay_NoMovies"	"CURRENTLY YOU HAVE NO SAVED MOVIES.\nYOU CAN SAVE REPLAYS INTO MOVIES AND SHARE THEM\nWITH YOUR FRIENDS."਍∀刀攀瀀氀愀礀开一漀䌀甀琀猀∀ऀ∀一伀 吀䤀䔀一䔀匀 一䤀一䜀唀一䄀 吀伀䴀䄀⸀ 倀唀䰀匀䄀 䔀䰀 䈀伀吀팀一 嘀䔀刀 䔀一 䰀䄀 倀䄀刀吀䔀 䤀一䘀䔀刀䤀伀刀 夀 䌀唀䄀一䐀伀 䰀䄀 䜀刀䄀䈀䄀䌀䤀팀一 䌀䄀刀䜀唀䔀Ⰰ 倀唀䰀匀䄀 㰀䔀匀倀䄀䌀䤀伀㸀 倀䄀刀䄀 䔀一吀刀䄀刀 䄀䰀 䔀䐀䤀吀伀刀⸀∀ഀഀ
"[english]Replay_NoCuts"	"CURRENTLY YOU HAVE NO TAKES.  CLICK THE WATCH BUTTON BELOW, THEN ONCE THE REPLAY LOADS, PRESS <SPACE> TO ENTER THE REPLAY EDITOR."਍∀刀攀瀀氀愀礀开䬀椀氀氀猀∀ऀ∀嘀촀䌀吀䤀䴀䄀匀∀ഀഀ
"[english]Replay_Kills"	"KILLS"਍∀刀攀瀀氀愀礀开匀琀愀琀䬀椀氀氀攀搀䈀礀∀ऀ∀䄀匀䔀匀䤀一䄀䐀伀 倀伀刀㨀∀ഀഀ
"[english]Replay_StatKilledBy"	"KILLED BY"਍∀刀攀瀀氀愀礀开伀渀䴀愀瀀∀ऀ∀䔀一 䔀䰀 䴀䄀倀䄀∀ഀഀ
"[english]Replay_OnMap"	"ON MAP"਍∀刀攀瀀氀愀礀开䰀椀昀攀∀ऀ∀䐀唀刀䄀䌀䤀팀一∀ഀഀ
"[english]Replay_Life"	"LENGTH"਍∀刀攀瀀氀愀礀开一漀渀攀∀ऀ∀㰀 一䄀䐀䤀䔀 㸀∀ഀഀ
"[english]Replay_None"	"< NONE >"਍∀刀攀瀀氀愀礀开刀攀渀搀攀爀吀椀洀攀∀ऀ∀吀䤀䔀䴀倀伀 䐀䔀 刀䔀一䐀䔀刀䤀娀䄀䐀伀∀ഀഀ
"[english]Replay_RenderTime"	"RENDER TIME"਍∀刀攀瀀氀愀礀开䐀攀昀愀甀氀琀䐀攀琀愀椀氀猀吀椀琀氀攀∀ऀ∀㰀栀愀稀 挀氀椀挀 瀀愀爀愀 攀搀椀琀愀爀 攀氀 琀琀甀氀漀㸀∀ഀഀ
"[english]Replay_DefaultDetailsTitle"	"< click to edit title >"਍∀刀攀瀀氀愀礀开圀愀琀挀栀∀ऀ∀嘀䔀刀 ⼀ 䔀䐀䤀吀䄀刀∀ഀഀ
"[english]Replay_Watch"	"WATCH / EDIT"਍∀刀攀瀀氀愀礀开夀漀甀吀甀戀攀唀瀀氀漀愀搀∀ऀ∀匀唀䈀䤀刀 䄀 夀伀唀吀唀䈀䔀∀ഀഀ
"[english]Replay_YouTubeUpload"	"YOUTUBE IT"਍∀刀攀瀀氀愀礀开夀漀甀吀甀戀攀∀ऀ∀夀漀甀吀甀戀攀∀∡ഀഀ
"[english]Replay_YouTube"	"YouTube™"਍∀刀攀瀀氀愀礀开夀漀甀吀甀戀攀嘀椀攀眀∀ऀ∀嘀䔀刀 䔀一 夀伀唀吀唀䈀䔀∀ഀഀ
"[english]Replay_YouTubeView"	"VIEW ON YOUTUBE"਍∀刀攀瀀氀愀礀开夀漀甀吀甀戀攀匀栀愀爀攀唀刀䰀∀ऀ∀䌀伀倀䤀䄀刀 唀刀䰀∀ഀഀ
"[english]Replay_YouTubeShareURL"	"COPY URL"਍∀刀攀瀀氀愀礀开䌀漀瀀礀唀刀䰀开吀椀琀氀攀∀ऀ∀ꄀ䔀渀氀愀挀攀 挀漀瀀椀愀搀漀℀∀ഀഀ
"[english]Replay_CopyURL_Title"	"Copied URL!"਍∀刀攀瀀氀愀礀开䌀漀瀀礀唀刀䰀开吀攀砀琀∀ऀ∀䔀氀 攀渀氀愀挀攀 愀 琀甀 瘀椀搀攀漀 攀渀 夀漀甀吀甀戀攀∀‡猀攀 栀愀 挀漀瀀椀愀搀漀 愀氀 瀀漀爀琀愀瀀愀瀀攀氀攀猀⸀∀ഀഀ
"[english]Replay_CopyURL_Text"	"The movie's YouTube™ URL has been copied to your clipboard."਍∀刀攀瀀氀愀礀开䌀氀椀挀欀吀漀䔀搀椀琀∀ऀ∀倀䤀一䌀䠀䄀 倀䄀刀䄀 䔀䐀䤀吀䄀刀∀ഀഀ
"[english]Replay_ClickToEdit"	"CLICK TO EDIT"਍∀刀攀瀀氀愀礀开倀氀愀礀攀搀䄀猀∀ऀ∀䨀唀䜀䄀䐀伀 䌀伀䴀伀㨀∀ഀഀ
"[english]Replay_PlayedAs"	"PLAYED AS:"਍∀刀攀瀀氀愀礀开䬀椀氀氀攀搀䈀礀∀ऀ∀䄀匀䔀匀䤀一䄀䐀伀 倀伀刀㨀∀ഀഀ
"[english]Replay_KilledBy"	"KILLED BY:"਍∀刀攀瀀氀愀礀开䰀椀昀攀䰀攀渀最琀栀∀ऀ∀䐀唀刀䄀䌀䤀팀一㨀∀ഀഀ
"[english]Replay_LifeLength"	"LENGTH:"਍∀刀攀瀀氀愀礀开一漀䬀椀氀氀攀爀∀ऀ∀匀䤀一 䄀匀䔀匀䤀一伀∀ഀഀ
"[english]Replay_NoKiller"	"NO KILLER"਍∀刀攀瀀氀愀礀开匀愀瘀攀吀栀椀猀䰀椀昀攀䴀猀最∀ऀ∀ꄀ倀甀氀猀愀 嬀─猀㄀崀 瀀愀爀愀 最甀愀爀搀愀爀 甀渀愀 最爀愀戀愀挀椀渀 搀攀 攀猀琀愀 瘀椀搀愀℀∀ഀഀ
"[english]Replay_SaveThisLifeMsg"	"Press [%s1] to save a Replay of this life!"਍∀刀攀瀀氀愀礀开䐀漀眀渀氀漀愀搀䌀漀洀瀀氀攀琀攀∀ऀ∀⸀⸀⸀搀攀猀挀愀爀最愀 挀漀洀瀀氀攀琀愀搀愀⸀ 倀椀渀挀栀愀 攀渀 䜀刀䄀䈀䄀䌀䤀伀一䔀匀 攀渀 攀氀 䴀䔀一 倀刀䤀一䌀䤀倀䄀䰀 瀀愀爀愀 瘀攀爀 琀甀 最爀愀戀愀挀椀渀⸀∀ഀഀ
"[english]Replay_DownloadComplete"	"...download complete!  Click REPLAYS in the MAIN MENU to view your replay."਍∀刀攀瀀氀愀礀开䐀漀眀渀氀漀愀搀䘀愀椀氀攀搀∀ऀ∀⸀⸀⸀氀愀 搀攀猀挀愀爀最愀 栀愀 昀愀氀氀愀搀漀⸀∀ഀഀ
"[english]Replay_DownloadFailed"	"...download failed!"਍∀刀攀瀀氀愀礀开一漀䬀攀礀䈀漀甀渀搀一漀刀攀瀀氀愀礀猀∀ऀ∀ꄀ一漀 栀愀礀 渀椀渀最甀渀愀 琀攀挀氀愀 愀猀漀挀椀愀搀愀 愀氀 最甀愀爀搀愀搀漀 搀攀 最爀愀戀愀挀椀漀渀攀猀℀ 嘀攀 愀 尀渀伀瀀挀椀漀渀攀猀 ⴀ㸀 吀攀挀氀愀搀漀 ⴀ㸀 䴀椀猀挀攀氀渀攀漀 瀀愀爀愀 攀猀瀀攀挀椀昀椀挀愀爀 甀渀愀⸀∀ഀഀ
"[english]Replay_NoKeyBoundNoReplays"	"You have no key set up for saving replays!  Go to\nOptions -> Keyboard -> Miscellaneous to set one up."਍∀刀攀瀀氀愀礀开一漀匀挀爀攀攀渀猀栀漀琀∀ऀ∀匀䤀一 䤀䴀䄀䜀䔀一∀ഀഀ
"[english]Replay_NoScreenshot"	"NO SCREENSHOT"਍∀刀攀瀀氀愀礀开䜀攀渀攀爀椀挀䴀猀最吀椀琀氀攀∀ऀ∀䜀爀愀戀愀挀椀渀∀ഀഀ
"[english]Replay_GenericMsgTitle"	"Replay"਍∀刀攀瀀氀愀礀开匀攀愀爀挀栀吀攀砀琀∀ऀ∀䈀甀猀挀愀爀∀ഀഀ
"[english]Replay_SearchText"	"Search"਍∀刀攀瀀氀愀礀开倀氀愀礀嘀漀椀挀攀∀ऀ∀䤀渀挀氀甀椀爀 挀栀愀琀 搀攀 瘀漀稀∀ഀഀ
"[english]Replay_PlayVoice"	"Include voice chat"਍∀刀攀瀀氀愀礀开刀攀渀搀攀爀䄀搀瘀愀渀挀攀搀伀瀀琀椀漀渀猀∀ऀ∀䴀漀猀琀爀愀爀 漀瀀挀椀漀渀攀猀 愀瘀愀渀稀愀搀愀猀∀ഀഀ
"[english]Replay_RenderAdvancedOptions"	"Show Advanced Options"਍∀刀攀瀀氀愀礀开刀攀渀搀攀爀匀攀琀琀椀渀最∀ऀ∀䌀愀氀椀搀愀搀 瘀椀搀攀漀㨀∀ഀഀ
"[english]Replay_RenderSetting"	"Movie Quality:"਍∀刀攀瀀氀愀礀开刀攀渀搀攀爀匀攀琀琀椀渀最开䰀漀眀∀ऀ∀䈀漀爀爀愀搀漀爀∀ഀഀ
"[english]Replay_RenderSetting_Low"	"Draft"਍∀刀攀瀀氀愀礀开刀攀渀搀攀爀匀攀琀琀椀渀最开䴀攀搀椀甀洀∀ऀ∀䔀猀琀渀搀愀爀∀ഀഀ
"[english]Replay_RenderSetting_Medium"	"Standard"਍∀刀攀瀀氀愀礀开刀攀渀搀攀爀匀攀琀琀椀渀最开䠀椀最栀∀ऀ∀䄀氀琀愀∀ഀഀ
"[english]Replay_RenderSetting_High"	"High"਍∀刀攀瀀氀愀礀开刀攀渀搀攀爀匀攀琀琀椀渀最开䴀愀砀∀ऀ∀䴀砀椀洀愀∀ഀഀ
"[english]Replay_RenderSetting_Max"	"Maximum"਍∀刀攀瀀氀愀礀开刀攀渀搀攀爀䔀猀琀椀洀愀琀攀开吀椀洀攀∀ऀ∀吀椀攀洀瀀漀 攀猀琀⸀ 搀攀 氀愀 爀攀渀搀攀爀椀稀愀挀椀渀㨀 搀攀 ─猀㄀ 愀 ─猀㈀∀ഀഀ
"[english]Replay_RenderEstimate_Time"	"Estimated Time To Render: %s1 to %s2"਍∀刀攀瀀氀愀礀开刀攀渀搀攀爀䔀猀琀椀洀愀琀攀开䘀椀氀攀∀ऀ∀吀愀洀愀漀 攀猀琀椀洀愀搀漀 搀攀 愀爀挀栀椀瘀漀㨀 ─猀㄀ 欀戀∀ഀഀ
"[english]Replay_RenderEstimate_File"	"Estimated File Size: %s1 kb"਍∀刀攀瀀氀愀礀开䰀漀挀欀圀愀爀渀椀渀最∀ऀ∀䄀嘀䤀匀伀㨀 ꄀ䈀氀漀焀甀攀愀爀 琀甀 攀焀甀椀瀀漀 搀甀爀愀渀琀攀 攀氀 爀攀渀搀攀爀椀稀愀搀漀 瀀甀攀搀攀 攀猀琀爀漀瀀攀愀爀 琀甀 瀀攀氀挀甀氀愀℀∀ഀഀ
"[english]Replay_LockWarning"	"WARNING: Locking your computer while rendering may corrupt your movie!"਍∀刀攀瀀氀愀礀开一攀砀琀堀∀ऀ∀匀䤀䜀唀䤀䔀一吀䔀 ─匀㄀∀ഀഀ
"[english]Replay_NextX"	"NEXT %s1"਍∀刀攀瀀氀愀礀开倀爀攀瘀堀∀ऀ∀䄀一吀䔀刀䤀伀刀 ─匀㄀∀ഀഀ
"[english]Replay_PrevX"	"PREVIOUS %s1"਍∀刀攀瀀氀愀礀开䈀愀挀欀䌀愀爀愀琀∀ऀ∀㰀㰀 䄀吀刀섀匀∀ഀഀ
"[english]Replay_BackCarat"	"<< BACK"਍∀刀攀瀀氀愀礀开一攀眀刀攀挀漀爀搀∀ऀ∀ꄀ一唀䔀嘀伀 刀준䌀伀刀䐀℀∀ഀഀ
"[english]Replay_NewRecord"	"NEW RECORD!"਍∀刀攀瀀氀愀礀开一漀一攀眀刀攀挀漀爀搀∀ऀ∀一漀 栀愀猀 戀愀琀椀搀漀 渀椀渀最甀渀 爀挀漀爀搀⸀ ꄀ䤀渀琀渀琀愀氀漀 氀愀 瀀爀漀砀椀洀愀 瘀攀稀℀∀ഀഀ
"[english]Replay_NoNewRecord"	"No record earned this time.  Try harder!"਍∀刀攀瀀氀愀礀开匀椀渀最氀攀圀漀爀搀䐀愀琀攀䄀渀搀吀椀洀攀∀ऀ∀─猀㄀ 愀 氀愀猀 ─猀㈀∀ഀഀ
"[english]Replay_SingleWordDateAndTime"	"%s1 @ %s2"਍∀刀攀瀀氀愀礀开䐀愀琀攀䄀渀搀吀椀洀攀∀ऀ∀─猀㈀ 搀攀 ─猀㄀ 搀攀 ─猀㌀ 愀 氀愀猀 ─猀㐀∀ഀഀ
"[english]Replay_DateAndTime"	"%s1 %s2, %s3 @ %s4"਍∀刀攀瀀氀愀礀开䐀愀琀攀∀ऀ∀─猀㈀ 搀攀 ─猀㄀ 搀攀 ─猀㌀∀ഀഀ
"[english]Replay_Date"	"%s1 %s2, %s3"਍∀刀攀瀀氀愀礀开吀漀搀愀礀∀ऀ∀䠀漀礀∀ഀഀ
"[english]Replay_Today"	"Today"਍∀刀攀瀀氀愀礀开夀攀猀琀攀爀搀愀礀∀ऀ∀䄀礀攀爀∀ഀഀ
"[english]Replay_Yesterday"	"Yesterday"਍∀刀攀瀀氀愀礀开䐀攀氀攀琀攀䔀搀椀琀䌀漀渀昀椀爀洀∀ऀ∀䔀猀琀愀 琀漀洀愀 猀攀爀 戀漀爀爀愀搀愀 瀀攀爀洀愀渀攀渀琀攀洀攀渀琀攀⸀∀ഀഀ
"[english]Replay_DeleteEditConfirm"	"This take will be permanently deleted."਍∀刀攀瀀氀愀礀开䐀攀氀攀琀攀刀攀瀀氀愀礀䌀漀渀昀椀爀洀∀ऀ∀䔀猀琀愀 最爀愀戀愀挀椀渀 礀 猀甀猀 爀攀猀瀀攀挀琀椀瘀愀猀 琀漀洀愀猀 猀攀爀渀 戀漀爀爀愀搀愀猀 瀀攀爀洀愀渀攀渀琀攀洀攀渀琀攀⸀∀ഀഀ
"[english]Replay_DeleteReplayConfirm"	"This replay and all accompanying takes will be permanently deleted."਍∀刀攀瀀氀愀礀开䐀攀氀攀琀攀䴀漀瘀椀攀䌀漀渀昀椀爀洀∀ऀ∀䔀猀琀攀 瘀椀搀攀漀 猀攀爀 戀漀爀爀愀搀漀 瀀攀爀洀愀渀攀渀琀攀洀攀渀琀攀⸀∀ഀഀ
"[english]Replay_DeleteMovieConfirm"	"This movie will be permanently deleted."਍∀刀攀瀀氀愀礀开刀漀甀渀搀䤀渀倀爀漀最爀攀猀猀∀ऀ∀䔀匀倀䔀刀䄀一䐀伀 䄀䰀 匀䔀刀嘀䤀䐀伀刀∀ഀഀ
"[english]Replay_RoundInProgress"	"WAITING FOR SERVER"਍∀刀攀瀀氀愀礀开刀攀渀搀攀爀䔀氀氀椀瀀猀椀猀∀ऀ∀䜀唀䄀刀䐀䄀刀尀渀䔀一 嘀촀䐀䔀伀∀ഀഀ
"[english]Replay_RenderEllipsis"	"SAVE TO MOVIE..."਍∀刀攀瀀氀愀礀开刀攀渀搀攀爀刀攀瀀氀愀礀∀ऀ∀刀䔀一䐀䔀刀䤀娀䄀䐀伀∀ഀഀ
"[english]Replay_RenderReplay"	"RENDER REPLAY"਍∀刀攀瀀氀愀礀开刀攀渀搀攀爀刀攀瀀氀愀礀猀∀ऀ∀刀䔀一䐀䔀刀䤀娀䄀䐀伀∀ഀഀ
"[english]Replay_RenderReplays"	"RENDER MOVIES"਍∀刀攀瀀氀愀礀开伀氀搀攀爀䴀漀瘀椀攀猀∀ऀ∀嘀촀䐀䔀伀匀 䄀一吀䔀刀䤀伀刀䔀匀㨀∀ഀഀ
"[english]Replay_OlderMovies"	"OLDER MOVIES:"਍∀刀攀瀀氀愀礀开刀攀渀搀攀爀攀搀∀ऀ∀嘀촀䐀䔀伀匀∀ഀഀ
"[english]Replay_Rendered"	"MOVIES"਍∀刀攀瀀氀愀礀开䜀漀∀ऀ∀伀䬀∀ഀഀ
"[english]Replay_Go"	"GO!"਍∀刀攀瀀氀愀礀开䠀椀最栀攀猀琀嘀椀搀攀漀∀ऀ∀刀攀渀搀攀爀椀稀愀爀 挀漀渀 氀愀 挀漀渀昀椀最甀爀愀挀椀渀 搀攀 瘀椀搀攀漀 洀猀 愀氀琀愀∀ഀഀ
"[english]Replay_HighestVideo"	"Render with highest video settings"਍∀刀攀瀀氀愀礀开儀甀椀琀圀栀攀渀䐀漀渀攀∀ऀ∀匀愀氀椀爀 愀氀 愀挀愀戀愀爀∀ഀഀ
"[english]Replay_QuitWhenDone"	"Quit when done"਍∀刀攀瀀氀愀礀开䔀渀愀戀氀攀䄀渀琀椀䄀氀椀愀猀椀渀最∀ऀ∀䄀挀琀椀瘀愀爀 匀甀愀瘀椀稀愀搀漀∀ഀഀ
"[english]Replay_EnableAntiAliasing"	"Enable Antialiasing"਍∀刀攀瀀氀愀礀开䔀渀愀戀氀攀嘀漀椀挀攀倀氀愀礀戀愀挀欀∀ऀ∀䜀爀愀戀愀爀 挀漀渀瘀攀爀猀愀挀椀漀渀攀猀 搀攀 瘀漀稀∀ഀഀ
"[english]Replay_EnableVoicePlayback"	"Record voice playback"਍∀刀攀瀀氀愀礀开伀瘀攀爀爀椀搀攀䘀漀瘀∀ऀ∀䄀渀甀氀愀爀 䘀伀嘀㨀∀ഀഀ
"[english]Replay_OverrideFov"	"Override FOV:"਍∀刀攀瀀氀愀礀开䐀攀氀攀琀攀䐀攀渀椀愀氀吀椀琀氀攀∀ऀ∀一漀 猀攀 瀀甀攀搀攀 戀漀爀爀愀爀 氀愀 最爀愀戀愀挀椀渀∀ഀഀ
"[english]Replay_DeleteDenialTitle"	"CAN'T DELETE REPLAY"਍∀刀攀瀀氀愀礀开䐀攀氀攀琀攀䐀攀渀椀愀氀吀攀砀琀∀ऀ∀䐀攀戀攀猀 戀漀爀爀愀爀 琀漀搀漀猀 氀漀猀 瘀椀搀攀漀猀 爀攀渀搀攀爀椀稀愀搀漀猀 愀猀漀挀椀愀搀漀猀 愀 攀猀琀愀 最爀愀戀愀挀椀渀 愀渀琀攀猀 搀攀 瀀漀搀攀爀 攀氀椀洀椀渀愀爀氀愀⸀∀ഀഀ
"[english]Replay_DeleteDenialText"	"You must delete all rendered movies associated with this replay before you can delete it."਍∀刀攀瀀氀愀礀开吀椀琀氀攀∀ऀ∀吀琀甀氀漀∀ഀഀ
"[english]Replay_Title"	"Title"਍∀刀攀瀀氀愀礀开䌀漀渀昀椀爀洀儀甀椀琀吀椀琀氀攀∀ऀ∀뼀匀攀最甀爀漀 焀甀攀 搀攀猀攀愀猀 猀愀氀椀爀㼀∀ഀഀ
"[english]Replay_ConfirmQuitTitle"	"Really Quit?"਍∀刀攀瀀氀愀礀开吀愀欀攀䴀攀吀漀刀攀瀀氀愀礀猀∀ऀ∀䰀氀瘀愀洀攀 愀 氀愀猀 最爀愀戀愀挀椀漀渀攀猀∀ഀഀ
"[english]Replay_TakeMeToReplays"	"Take me to the replays"਍∀刀攀瀀氀愀礀开夀攀猀刀攀愀氀氀礀儀甀椀琀∀ऀ∀匀Ⰰ 焀甀椀攀爀漀 猀愀氀椀爀∀ഀഀ
"[english]Replay_YesReallyQuit"	"Yes, really quit"਍∀刀攀瀀氀愀礀开䌀漀渀昀椀爀洀儀甀椀琀∀ऀ∀吀椀攀渀攀猀 最爀愀戀愀挀椀漀渀攀猀 琀攀洀瀀漀爀愀氀攀猀 焀甀攀 瀀甀攀搀攀渀 瀀攀爀搀攀爀猀攀尀渀猀椀 猀愀氀攀猀 猀椀渀 最甀愀爀搀愀爀氀愀猀 挀漀洀漀 瘀搀攀漀猀⸀∀ഀഀ
"[english]Replay_ConfirmQuit"	"You have temporary replays that may be lost\nif you quit before saving them as movies."਍∀刀攀瀀氀愀礀开䌀愀渀挀攀氀刀攀渀搀攀爀吀椀琀氀攀∀ऀ∀뼀䌀愀渀挀攀氀愀爀 爀攀渀搀攀爀椀稀愀搀漀㼀∀ഀഀ
"[english]Replay_CancelRenderTitle"	"Cancel render?"਍∀刀攀瀀氀愀礀开䌀漀渀昀椀爀洀䌀愀渀挀攀氀刀攀渀搀攀爀∀ऀ∀뼀匀攀最甀爀漀 焀甀攀 焀甀椀攀爀攀猀 挀愀渀挀攀氀愀爀 攀氀 爀攀渀搀攀爀椀稀愀搀漀㼀∀ഀഀ
"[english]Replay_ConfirmCancelRender"	"Are you sure you want to cancel rendering?"਍∀刀攀瀀氀愀礀开夀攀猀䌀愀渀挀攀氀∀ऀ∀匀Ⰰ 挀愀渀挀攀氀愀爀∀ഀഀ
"[english]Replay_YesCancel"	"Yes, cancel"਍∀刀攀瀀氀愀礀开䌀愀渀挀攀氀刀攀渀搀攀爀∀ऀ∀堀 䌀䄀一䌀䔀䰀䄀刀∀ഀഀ
"[english]Replay_CancelRender"	"X CANCEL"਍∀刀攀瀀氀愀礀开䌀愀渀挀攀氀∀ऀ∀䌀䄀一䌀䔀䰀䄀刀∀ഀഀ
"[english]Replay_Cancel"	"CANCEL"਍∀刀攀瀀氀愀礀开刀攀渀搀攀爀倀爀攀瘀椀攀眀∀ऀ∀䄀挀琀椀瘀愀爀 瘀椀猀琀愀 瀀爀攀瘀椀愀 ⠀洀猀 氀攀渀琀漀⤀∀ഀഀ
"[english]Replay_RenderPreview"	"Enable preview (slower)"਍∀刀攀瀀氀愀礀开刀攀渀搀攀爀一漀眀∀ऀ∀䜀甀愀爀搀愀爀 氀漀猀 瘀椀搀攀漀猀 礀 挀攀爀爀愀爀∀ഀഀ
"[english]Replay_RenderNow"	"Save movies now, then quit"਍∀刀攀瀀氀愀礀开䐀漀渀琀匀栀漀眀吀栀椀猀䄀最愀椀渀∀ऀ∀一漀 洀漀猀琀爀愀爀 攀猀琀攀 洀攀渀猀愀樀攀 搀攀 渀甀攀瘀漀∀ഀഀ
"[english]Replay_DontShowThisAgain"	"Don't show this message again"਍∀刀攀瀀氀愀礀开刀攀渀搀攀爀䔀搀椀琀吀椀琀氀攀∀ऀ∀䌀漀渀昀椀最甀爀愀挀椀渀 搀攀 氀愀 琀漀洀愀∀ഀഀ
"[english]Replay_RenderEditTitle"	"Shot Settings"਍∀刀攀瀀氀愀礀开刀攀渀搀攀爀䔀搀椀琀䘀漀瘀∀ऀ∀䌀愀洀瀀漀 搀攀 瘀椀猀椀渀 搀攀 氀愀 挀洀愀爀愀∀ഀഀ
"[english]Replay_RenderEditFov"	"Camera field of view"਍∀刀攀瀀氀愀礀开刀攀渀搀攀爀䔀搀椀琀䌀愀洀䴀漀瘀攀匀瀀攀攀搀∀ऀ∀嘀攀氀漀挀椀搀愀搀 搀攀 洀漀瘀椀洀椀攀渀琀漀 搀攀 氀愀 挀洀愀爀愀∀ഀഀ
"[english]Replay_RenderEditCamMoveSpeed"	"Camera move speed"਍∀刀攀瀀氀愀礀开刀攀渀搀攀爀䔀搀椀琀䌀愀洀刀漀琀匀瀀攀攀搀∀ऀ∀嘀攀氀漀挀椀搀愀搀 搀攀 爀漀琀愀挀椀渀 搀攀 氀愀 挀洀愀爀愀∀ഀഀ
"[english]Replay_RenderEditCamRotSpeed"	"Camera rotation speed"਍∀刀攀瀀氀愀礀开䄀猀瀀攀挀琀刀愀琀椀漀∀ऀ∀刀攀氀愀挀椀渀 搀攀 愀猀瀀攀挀琀漀∀ഀഀ
"[english]Replay_AspectRatio"	"Aspect Ratio"਍∀刀攀瀀氀愀礀开刀攀猀攀琀∀ऀ∀刀攀椀渀椀挀椀愀爀∀ഀഀ
"[english]Replay_Reset"	"Reset"਍∀刀攀瀀氀愀礀开刀攀瀀氀愀礀䤀渀琀爀漀吀椀琀氀攀∀ऀ∀最爀愀戀愀挀椀渀 ⴀ ꄀ氀攀洀攀℀∀ഀഀ
"[english]Replay_ReplayIntroTitle"	"replay - read this!"਍∀刀攀瀀氀愀礀开䌀漀渀昀椀爀洀䐀椀猀挀漀渀渀攀挀琀䘀爀漀洀匀攀爀瘀攀爀∀ऀ∀䔀猀琀漀 栀愀爀 焀甀攀 氀愀 瀀愀爀琀椀搀愀 愀挀琀甀愀氀 愀挀愀戀攀⸀∀ഀഀ
"[english]Replay_ConfirmDisconnectFromServer"	"This will end your current game."਍∀刀攀瀀氀愀礀开䘀椀爀猀琀倀攀爀猀漀渀∀ऀ∀倀爀椀洀攀爀愀 瀀攀爀猀漀渀愀∀ഀഀ
"[english]Replay_FirstPerson"	"First-person"਍∀刀攀瀀氀愀礀开䌀栀愀猀攀∀ऀ∀倀攀爀猀攀挀甀挀椀渀∀ഀഀ
"[english]Replay_Chase"	"Chase"਍∀刀攀瀀氀愀礀开䘀爀攀攀∀ऀ∀䰀椀戀爀攀∀ഀഀ
"[english]Replay_Free"	"Free"਍∀刀攀瀀氀愀礀开倀愀甀猀攀∀ऀ∀倀愀甀猀愀爀⼀挀漀渀琀椀渀甀愀爀∀ഀഀ
"[english]Replay_Pause"	"Pause/unpause"਍∀刀攀瀀氀愀礀开匀氀漀眀䴀漀∀ऀ∀䌀섀䴀䄀刀䄀 䰀䔀一吀䄀∀ഀഀ
"[english]Replay_SlowMo"	"SLOW-MO"਍∀刀攀瀀氀愀礀开刀攀渀搀攀爀伀瘀攀爀氀愀礀吀攀砀琀∀ऀ∀䜀甀愀爀搀愀渀搀漀尀渀瘀搀攀漀⸀⸀⸀∀ഀഀ
"[english]Replay_RenderOverlayText"	"Saving movie..."਍∀刀攀瀀氀愀礀开刀攀渀搀攀爀伀瘀攀爀氀愀礀开吀椀洀攀䰀攀昀琀∀ऀ∀吀椀攀洀瀀漀㨀 ─猀㄀ ⠀─猀㈀ 爀攀猀琀愀渀琀攀⤀∀ഀഀ
"[english]Replay_RenderOverlay_TimeLeft"	"Time: %s1 (%s2 left)"਍∀刀攀瀀氀愀礀开䔀砀瀀漀爀琀刀愀眀∀ऀ∀䔀砀瀀漀爀琀愀爀 挀漀洀漀 吀䜀䄀⼀圀䄀嘀∀ഀഀ
"[english]Replay_ExportRaw"	"Export raw TGA's/WAV"਍∀刀攀瀀氀愀礀开唀猀攀儀甀椀挀欀吀椀洀攀∀ऀ∀唀猀愀爀 攀氀 挀漀搀椀昀椀挀愀搀漀爀 儀甀椀挀欀吀椀洀攀∀ഀഀ
"[english]Replay_UseQuickTime"	"Use QuickTime encoder"਍∀刀攀瀀氀愀礀开䄀挀挀攀氀䴀椀渀∀ऀ∀䴀攀渀漀猀∀ഀഀ
"[english]Replay_AccelMin"	"Less"਍∀刀攀瀀氀愀礀开䄀挀挀攀氀䴀愀砀∀ऀ∀䴀猀∀ഀഀ
"[english]Replay_AccelMax"	"More"਍∀刀攀瀀氀愀礀开匀瀀攀攀搀䴀椀渀∀ऀ∀䴀猀 氀攀渀琀漀∀ഀഀ
"[english]Replay_SpeedMin"	"Slower"਍∀刀攀瀀氀愀礀开匀瀀攀攀搀䴀愀砀∀ऀ∀䴀猀 爀瀀椀搀漀∀ഀഀ
"[english]Replay_SpeedMax"	"Faster"਍∀刀攀瀀氀愀礀开䘀爀攀攀䌀愀洀∀ऀ∀䌀섀䴀䄀刀䄀 䰀䤀䈀刀䔀∀ഀഀ
"[english]Replay_FreeCam"	"FREE-CAM"਍∀刀攀瀀氀愀礀开䘀漀瘀䴀椀渀∀ऀ∀䴀猀 攀猀琀爀攀挀栀漀∀ഀഀ
"[english]Replay_FovMin"	"Narrower"਍∀刀攀瀀氀愀礀开䘀漀瘀䴀愀砀∀ऀ∀䴀猀 愀渀挀栀漀∀ഀഀ
"[english]Replay_FovMax"	"Wider"਍∀刀攀瀀氀愀礀开刀漀琀䘀椀氀琀攀爀䴀椀渀∀ऀ∀匀椀渀 昀椀氀琀爀愀爀∀ഀഀ
"[english]Replay_RotFilterMin"	"Unfiltered"਍∀刀攀瀀氀愀礀开刀漀琀䘀椀氀琀攀爀䴀愀砀∀ऀ∀䘀椀氀琀爀愀搀漀∀ഀഀ
"[english]Replay_RotFilterMax"	"Filtered"਍∀刀攀瀀氀愀礀开匀栀愀欀攀匀瀀攀攀搀∀ऀ∀嘀攀氀漀挀椀搀愀搀 搀攀氀 琀攀洀戀氀漀爀㨀∀ഀഀ
"[english]Replay_ShakeSpeed"	"Shake Speed:"਍∀刀攀瀀氀愀礀开匀栀愀欀攀匀瀀攀攀搀䴀椀渀∀ऀ∀䰀攀渀琀愀∀ഀഀ
"[english]Replay_ShakeSpeedMin"	"Slow"਍∀刀攀瀀氀愀礀开匀栀愀欀攀匀瀀攀攀搀䴀愀砀∀ऀ∀刀瀀椀搀愀∀ഀഀ
"[english]Replay_ShakeSpeedMax"	"Fast"਍∀刀攀瀀氀愀礀开匀栀愀欀攀䄀洀漀甀渀琀∀ऀ∀倀漀琀攀渀挀椀愀 搀攀氀 琀攀洀戀氀漀爀㨀∀ഀഀ
"[english]Replay_ShakeAmount"	"Shake Amount:"਍∀刀攀瀀氀愀礀开匀栀愀欀攀䄀洀漀甀渀琀䴀椀渀∀ऀ∀䌀愀氀洀愀∀ഀഀ
"[english]Replay_ShakeAmountMin"	"Calm"਍∀刀攀瀀氀愀礀开匀栀愀欀攀䄀洀漀甀渀琀䴀愀砀∀ऀ∀吀攀爀爀攀洀漀琀漀∀ഀഀ
"[english]Replay_ShakeAmountMax"	"Earthquake"਍∀刀攀瀀氀愀礀开匀栀愀欀攀䐀椀爀∀ऀ∀䐀椀爀攀挀挀椀渀 搀攀氀 琀攀洀戀氀漀爀㨀∀ഀഀ
"[english]Replay_ShakeDir"	"Shake Direction:"਍∀刀攀瀀氀愀礀开匀栀愀欀攀䐀椀爀䴀椀渀∀ऀ∀䰀愀琀攀爀愀氀∀ഀഀ
"[english]Replay_ShakeDirMin"	"Lateral"਍∀刀攀瀀氀愀礀开匀栀愀欀攀䐀椀爀䴀愀砀∀ऀ∀嘀攀爀琀椀挀愀氀∀ഀഀ
"[english]Replay_ShakeDirMax"	"Vertical"਍∀刀攀瀀氀愀礀开䄀挀挀攀氀∀ऀ∀䄀挀攀氀攀爀愀挀椀渀㨀∀ഀഀ
"[english]Replay_Accel"	"Acceleration:"਍∀刀攀瀀氀愀礀开匀瀀攀攀搀∀ऀ∀嘀攀氀漀挀椀搀愀搀㨀∀ഀഀ
"[english]Replay_Speed"	"Speed:"਍∀刀攀瀀氀愀礀开䘀漀瘀∀ऀ∀䌀愀洀瀀漀 搀攀 嘀椀猀椀渀㨀∀ഀഀ
"[english]Replay_Fov"	"Fov:"਍∀刀攀瀀氀愀礀开刀漀琀䘀椀氀琀攀爀∀ऀ∀䘀椀氀琀爀漀 搀攀 刀漀琀愀挀椀渀㨀∀ഀഀ
"[english]Replay_RotFilter"	"Rotation Filter:"਍∀刀攀瀀氀愀礀开吀椀洀攀匀挀愀氀攀䴀椀渀∀ऀ∀䌀洀愀爀愀 氀攀渀琀愀∀ഀഀ
"[english]Replay_TimeScaleMin"	"Slow-mo"਍∀刀攀瀀氀愀礀开吀椀洀攀匀挀愀氀攀䴀愀砀∀ऀ∀䌀洀愀爀愀 爀瀀椀搀愀∀ഀഀ
"[english]Replay_TimeScaleMax"	"Time-lapse"਍∀刀攀瀀氀愀礀开匀挀愀氀攀∀ऀ∀䔀猀挀愀氀愀㨀∀ഀഀ
"[english]Replay_Scale"	"Scale:"਍∀刀攀瀀氀愀礀开匀攀琀䐀攀昀愀甀氀琀匀攀琀琀椀渀最∀ऀ∀刀䔀䤀一䤀䌀䤀䄀刀∀ഀഀ
"[english]Replay_SetDefaultSetting"	"RESET"਍∀刀攀瀀氀愀礀开刀攀猀攀琀吀椀洀攀匀挀愀氀攀∀ऀ∀刀䔀䤀一䤀䌀䤀䄀刀∀ഀഀ
"[english]Replay_ResetTimeScale"	"RESET"਍∀刀攀瀀氀愀礀开吀椀洀攀匀挀愀氀攀∀ऀ∀䔀匀䌀䄀䰀䄀 䐀䔀 吀䤀䔀䴀倀伀∀ഀഀ
"[english]Replay_TimeScale"	"TIME SCALE"਍∀刀攀瀀氀愀礀开伀爀椀最椀渀愀氀∀ऀ∀伀刀䤀䜀䤀一䄀䰀㨀∀ഀഀ
"[english]Replay_Original"	"ORIGINAL:"਍∀刀攀瀀氀愀礀开倀攀爀昀漀爀洀愀渀挀攀猀∀ऀ∀吀伀䴀䄀匀㨀∀ഀഀ
"[english]Replay_Performances"	"TAKES:"਍∀刀攀瀀氀愀礀开圀愀爀渀椀渀最∀ऀ∀䄀搀瘀攀爀琀攀渀挀椀愀∀ഀഀ
"[english]Replay_Warning"	"Warning"਍∀刀攀瀀氀愀礀开吀椀瀀∀ऀ∀䌀漀渀猀攀樀漀∀ഀഀ
"[english]Replay_Tip"	"Tip"਍∀刀攀瀀氀愀礀开一甀欀攀倀攀爀昀漀爀洀愀渀挀攀䌀栀愀渀最攀猀∀ऀ∀䌀甀愀氀焀甀椀攀爀 挀愀洀戀椀漀 爀攀愀氀椀稀愀搀漀 愀 瀀愀爀琀椀爀 搀攀 攀猀琀攀 洀漀洀攀渀琀漀 猀攀爀 搀攀猀挀愀爀琀愀搀漀 猀椀 搀攀挀椀搀攀猀 挀漀渀琀椀渀甀愀爀⸀尀渀䌀甀愀氀焀甀椀攀爀 渀甀攀瘀漀 挀愀洀戀椀漀 焀甀攀 猀攀 爀攀愀氀椀挀攀 愀 瀀愀爀琀椀爀 搀攀 攀猀琀攀 瀀甀渀琀漀 猀攀爀 最爀愀戀愀搀漀 攀渀 猀甀 氀甀最愀爀⸀∀ഀഀ
"[english]Replay_NukePerformanceChanges"	"Changes after the current time will be discarded if you choose to proceed.\n\nAny new changes made from this point will be recorded in their place."਍∀刀攀瀀氀愀礀开唀猀攀儀甀椀挀欀吀椀洀攀倀氀愀礀攀爀∀ऀ∀匀攀 爀攀挀漀洀椀攀渀搀愀 甀琀椀氀椀稀愀爀 儀甀椀挀欀吀椀洀攀 瀀愀爀愀 瘀攀爀 氀漀猀 瘀椀搀攀漀猀 最甀愀爀搀愀搀漀猀⸀∀ഀഀ
"[english]Replay_UseQuickTimePlayer"	"It is recommended that you use QuickTime to view saved movies."਍∀刀攀瀀氀愀礀开吀栀愀渀欀猀䤀圀椀氀氀∀ऀ∀䜀爀愀挀椀愀猀Ⰰ 氀漀 栀愀爀∀ഀഀ
"[english]Replay_ThanksIWill"	"Thanks, I will"਍∀刀攀瀀氀愀礀开匀愀瘀攀䄀猀∀ऀ∀䜀甀愀爀搀愀爀 挀漀洀漀⸀⸀⸀∀ഀഀ
"[english]Replay_SaveAs"	"Save As..."਍∀刀攀瀀氀愀礀开䔀砀椀琀∀ऀ∀匀愀氀椀爀 搀攀氀 攀搀椀琀漀爀∀ഀഀ
"[english]Replay_Exit"	"Exit Replay Editor"਍∀刀攀瀀氀愀礀开䴀漀琀椀漀渀䈀氀甀爀∀ऀ∀䌀愀氀椀搀愀搀 搀攀氀尀渀搀攀猀攀渀昀漀焀甀攀尀渀搀攀 洀漀瘀椀洀椀攀渀琀漀∀ഀഀ
"[english]Replay_MotionBlur"	"Motion Blur Quality"਍∀刀攀瀀氀愀礀开䴀漀琀椀漀渀䈀氀甀爀开䰀漀眀∀ऀ∀䈀愀樀愀∀ഀഀ
"[english]Replay_MotionBlur_Low"	"Low"਍∀刀攀瀀氀愀礀开䴀漀琀椀漀渀䈀氀甀爀开䠀椀最栀∀ऀ∀䄀氀琀愀∀ഀഀ
"[english]Replay_MotionBlur_High"	"High"਍∀刀攀瀀氀愀礀开䴀漀琀椀漀渀䈀氀甀爀开䔀渀愀戀氀攀搀∀ऀ∀䄀挀琀椀瘀愀爀 䐀攀猀攀渀昀漀焀甀攀 搀攀 䴀漀瘀椀洀椀攀渀琀漀 ⠀椀渀挀爀攀洀攀渀琀愀爀 攀氀 琀椀攀洀瀀漀 搀攀 爀攀渀搀攀爀椀稀愀搀漀⤀∀ഀഀ
"[english]Replay_MotionBlur_Enabled"	"Enable Motion Blur (will increase rendering time)"਍∀刀攀瀀氀愀礀开䜀氀漀眀开䔀渀愀戀氀攀搀∀ऀ∀䄀挀琀椀瘀愀爀 攀昀攀挀琀漀 搀攀 椀氀甀洀椀渀愀搀漀∀ഀഀ
"[english]Replay_Glow_Enabled"	"Enable Glow Effect"਍∀刀攀瀀氀愀礀开䌀漀搀攀挀∀ऀ∀䌀搀攀挀 搀攀 瘀椀搀攀漀∀ഀഀ
"[english]Replay_Codec"	"Video Codec"਍∀刀攀瀀氀愀礀开䌀漀搀攀挀开䠀㈀㘀㐀∀ऀ∀䰀攀渀琀漀Ⰰ 挀愀氀椀搀愀搀 瀀琀椀洀愀 ⠀䠀⸀㈀㘀㐀⤀∀ഀഀ
"[english]Replay_Codec_H264"	"Slower, Best Quality (H.264)"਍∀刀攀瀀氀愀礀开䌀漀搀攀挀开䴀䨀倀䔀䜀䄀∀ऀ∀刀瀀椀搀漀Ⰰ 愀爀挀栀椀瘀漀 最爀愀渀搀攀 ⠀䴀䨀倀䔀䜀ⴀ䄀⤀∀ഀഀ
"[english]Replay_Codec_MJPEGA"	"Faster, Larger File (MJPEG-A)"਍∀刀攀瀀氀愀礀开儀甀愀氀椀琀礀∀ऀ∀䌀愀氀椀搀愀搀 搀攀氀尀渀爀攀渀搀攀爀椀稀愀搀漀∀ഀഀ
"[english]Replay_Quality"	"Render Quality"਍∀刀攀瀀氀愀礀开儀甀愀氀椀琀礀开䰀漀眀∀ऀ∀䈀愀樀愀 ⠀愀昀攀挀琀愀 愀氀 琀愀洀⸀ 搀攀氀 愀爀挀栀⸀⤀∀ഀഀ
"[english]Replay_Quality_Low"	"Low (affects file size)"਍∀刀攀瀀氀愀礀开儀甀愀氀椀琀礀开䠀椀最栀∀ऀ∀䄀氀琀愀∀ഀഀ
"[english]Replay_Quality_High"	"High"਍∀刀攀瀀氀愀礀开䔀砀瀀漀爀琀䴀漀瘀椀攀∀ऀ∀䔀堀倀伀刀吀䄀刀∀ഀഀ
"[english]Replay_ExportMovie"	"EXPORT"਍∀刀攀瀀氀愀礀开䘀椀渀搀䔀砀瀀漀爀琀䴀漀瘀椀攀䰀漀挀愀琀椀漀渀∀ऀ∀一漀洀戀爀攀 搀攀氀 嘀搀攀漀 䔀砀瀀漀爀琀愀搀漀∀ഀഀ
"[english]Replay_FindExportMovieLocation"	"Exported Movie Filename"਍∀刀攀瀀氀愀礀开䔀砀瀀漀爀琀䴀漀瘀椀攀䔀爀爀漀爀开吀椀琀氀攀∀ऀ∀䔀爀爀漀爀∀ഀഀ
"[english]Replay_ExportMovieError_Title"	"Error"਍∀刀攀瀀氀愀礀开䔀砀瀀漀爀琀䴀漀瘀椀攀䔀爀爀漀爀开吀攀砀琀∀ऀ∀一漀 猀攀 瀀甀搀漀 攀砀瀀漀爀琀愀爀 攀氀 瘀椀搀攀漀 愀氀 搀椀爀攀挀琀漀爀椀漀 攀猀瀀攀挀椀昀椀挀愀搀漀⸀ 䄀猀攀最切爀愀琀攀 搀攀 焀甀攀 栀愀礀 猀甀昀椀挀椀攀渀琀攀 攀猀瀀愀挀椀漀 攀渀 攀氀 搀椀猀挀漀 礀 焀甀攀 琀椀攀渀攀猀 瀀攀爀洀椀猀漀猀 搀攀 甀猀甀愀爀椀漀 猀甀昀椀挀椀攀渀琀攀猀⸀∀ഀഀ
"[english]Replay_ExportMovieError_Text"	"Unable to export the movie to the location specified. Please ensure that there is enough disk space and that you have sufficient permissions."਍∀刀攀瀀氀愀礀开䔀砀瀀漀爀琀䴀漀瘀椀攀一漀䘀椀氀攀开吀攀砀琀∀ऀ∀一漀 猀攀 瀀甀搀漀 攀砀瀀漀爀琀愀爀 氀愀 瀀攀氀挀甀氀愀 礀愀 焀甀攀 渀漀 猀攀 栀愀 攀渀挀漀渀琀爀愀搀漀 攀氀 愀爀挀栀椀瘀漀⸀∀ഀഀ
"[english]Replay_ExportMovieNoFile_Text"	"Unable to export the movie, because the movie file could not be found."਍∀刀攀瀀氀愀礀开䔀砀瀀漀爀琀䴀漀瘀椀攀匀甀挀挀攀猀猀开吀椀琀氀攀∀ऀ∀䌀漀洀瀀氀攀琀愀搀漀∀ഀഀ
"[english]Replay_ExportMovieSuccess_Title"	"Success"਍∀刀攀瀀氀愀礀开䔀砀瀀漀爀琀䴀漀瘀椀攀匀甀挀挀攀猀猀开吀攀砀琀∀ऀ∀ꄀ䔀氀 瘀椀搀攀漀 栀愀 猀椀搀漀 攀砀瀀漀爀琀愀搀漀 挀漀渀 砀椀琀漀℀∀ഀഀ
"[english]Replay_ExportMovieSuccess_Text"	"The movie has been exported successfully!"਍∀刀攀瀀氀愀礀开䴀漀瘀椀攀䘀椀氀攀猀∀ऀ∀嘀椀搀攀漀 儀甀椀挀欀吀椀洀攀∀ഀഀ
"[english]Replay_MovieFiles"	"QuickTime Movie"਍∀刀攀瀀氀愀礀开倀攀爀昀吀椀瀀开䔀渀琀攀爀倀攀爀昀䴀漀搀攀∀ऀ∀倀䄀刀䄀 䔀一吀刀䄀刀 䔀一 䔀䰀 䔀䐀䤀吀伀刀 䐀䔀 䜀刀䄀䈀䄀䌀䤀伀一䔀匀Ⰰ尀尀一倀唀䰀匀䄀 䔀匀倀䄀䌀䤀伀⸀∀ഀഀ
"[english]Replay_PerfTip_EnterPerfMode"	"TO ENTER THE REPLAY EDITOR, PRESS SPACE."਍∀刀攀瀀氀愀礀开倀攀爀昀吀椀瀀开䔀砀椀琀倀攀爀昀䴀漀搀攀∀ऀ∀倀䄀刀䄀 匀䄀䰀䤀刀 䐀䔀䰀 䔀䐀䤀吀伀刀 䐀䔀 䜀刀䄀䈀䄀䌀䤀伀一䔀匀 夀尀尀一刀䔀䄀一唀䐀䄀刀 䔀䰀 嘀촀䐀䔀伀Ⰰ 倀唀䰀匀䄀 䔀匀倀䄀䌀䤀伀⸀∀ഀഀ
"[english]Replay_PerfTip_ExitPerfMode"	"TO EXIT THE REPLAY EDITOR AND UNPAUSE, PRESS SPACE."਍∀刀攀瀀氀愀礀开倀攀爀昀吀椀瀀开䔀砀椀琀䘀爀攀攀䌀愀洀∀ऀ∀倀䄀刀䄀 䐀䔀匀䈀䰀伀儀唀䔀䄀刀 䔀䰀 䌀唀刀匀伀刀 䐀䔀䰀 刀䄀吀팀一Ⰰ尀尀一䠀䄀娀 䌀䰀䤀䌀 䤀娀儀唀䤀䔀刀䐀伀⸀∀ഀഀ
"[english]Replay_PerfTip_ExitFreeCam"	"TO RELEASE THE MOUSE CURSOR, LEFT-CLICK."਍∀刀攀瀀氀愀礀开倀攀爀昀吀椀瀀开䔀渀琀攀爀䘀爀攀攀䌀愀洀∀ऀ∀倀䄀刀䄀 刀伀吀䄀刀 䰀䄀 䌀섀䴀䄀刀䄀Ⰰ 䠀䄀娀 䌀䰀䤀䌀 䤀娀儀唀䤀䔀刀䐀伀 䔀一 䰀䄀 嘀䔀一吀䄀一䄀 䐀䔀 倀刀䔀嘀䤀匀唀䄀䰀䤀娀䄀䌀䤀팀一 夀 䴀唀䔀嘀䔀 䔀䰀 刀䄀吀팀一⸀尀尀一倀䄀刀䄀 䴀伀嘀䔀刀吀䔀 䐀䔀 䘀伀刀䴀䄀 䠀伀刀䤀娀伀一吀䄀䰀 唀匀䄀 䰀䄀匀 吀䔀䌀䰀䄀匀 ✀圀✀ ⼀ ✀䄀✀ ⼀ ✀匀✀ ⼀ ✀䐀✀⸀尀尀倀䄀刀䄀 䴀伀嘀䔀刀吀䔀 嘀䔀刀吀䤀䌀䄀䰀䴀䔀一吀䔀 唀匀䄀 ✀娀✀ 夀 ✀堀✀⸀∀ഀഀ
"[english]Replay_PerfTip_EnterFreeCam"	"TO ROTATE THE CAMERA, LEFT-CLICK IN THE VIEWPORT AND MOVE THE MOUSE.\nTO MOVE AROUND HORIZONTALLY, USE THE 'W' / 'A' / 'S' / 'D' KEYS.\nFOR VERTICAL MOVEMENT, USE 'Z' AND 'X'."਍∀刀攀瀀氀愀礀开倀攀爀昀吀椀瀀开䤀渀倀漀椀渀琀匀攀琀∀ऀ∀䴀䄀刀䌀䄀䐀伀刀 䐀䔀 䌀伀䴀䤀䔀一娀伀 䘀䤀䨀䄀䐀伀⸀∀ഀഀ
"[english]Replay_PerfTip_InPointSet"	"IN POINT SET."਍∀刀攀瀀氀愀礀开倀攀爀昀吀椀瀀开䤀渀倀漀椀渀琀刀攀洀漀瘀攀搀∀ऀ∀䴀䄀刀䌀䄀䐀伀刀 䐀䔀 䌀伀䴀䤀䔀一娀伀 䔀䰀䤀䴀䤀一䄀䐀伀⸀∀ഀഀ
"[english]Replay_PerfTip_InPointRemoved"	"IN POINT REMOVED."਍∀刀攀瀀氀愀礀开倀攀爀昀吀椀瀀开伀甀琀倀漀椀渀琀匀攀琀∀ऀ∀䴀䄀刀䌀䄀䐀伀刀 䐀䔀 䘀䤀一 䘀䤀䨀䄀䐀伀⸀∀ഀഀ
"[english]Replay_PerfTip_OutPointSet"	"OUT POINT SET."਍∀刀攀瀀氀愀礀开倀攀爀昀吀椀瀀开伀甀琀倀漀椀渀琀刀攀洀漀瘀攀搀∀ऀ∀䴀䄀刀䌀䄀䐀伀刀 䐀䔀 䘀䤀一 䔀䰀䤀䴀䤀一䄀䐀伀⸀∀ഀഀ
"[english]Replay_PerfTip_OutPointRemoved"	"OUT POINT REMOVED."਍∀刀攀瀀氀愀礀开倀攀爀昀吀椀瀀开一漀眀刀攀挀漀爀搀椀渀最∀ऀ∀䜀刀䄀䈀䄀䌀䤀팀一 䤀一䤀䌀䤀䄀䐀䄀⸀∀ഀഀ
"[english]Replay_PerfTip_NowRecording"	"RECORDING STARTED."਍∀刀攀瀀氀愀礀开倀攀爀昀吀椀瀀开匀渀椀瀀∀ऀ∀⨀䌀伀刀吀䔀⨀∀ഀഀ
"[english]Replay_PerfTip_Snip"	"*SNIP*"਍∀刀攀瀀氀愀礀开倀攀爀昀吀椀瀀开匀愀瘀攀搀∀ऀ∀吀伀䴀䄀 䜀唀䄀刀䐀䄀䐀䄀 匀䄀吀䤀匀䘀䄀䌀吀伀刀䤀䄀䴀䔀一吀䔀⸀∀ഀഀ
"[english]Replay_PerfTip_Saved"	"TAKE SAVED SUCCESSFULLY."਍∀刀攀瀀氀愀礀开倀攀爀昀吀椀瀀开匀愀瘀攀䘀愀椀氀攀搀∀ऀ∀ꄀ䔀刀刀伀刀 䄀䰀 䜀唀䄀刀䐀䄀刀 䰀䄀 吀伀䴀䄀℀∀ഀഀ
"[english]Replay_PerfTip_SaveFailed"	"TAKE FAILED TO SAVE!"਍∀刀攀瀀氀愀礀开倀攀爀昀吀椀瀀开䔀渀搀伀昀刀攀瀀氀愀礀刀攀愀挀栀攀搀∀ऀ∀䠀䄀匀 䰀䰀䔀䜀䄀䐀伀 䄀䰀 䘀䤀一 䐀䔀 䰀䄀 䜀刀䄀䈀䄀䌀䤀팀一⸀∀ഀഀ
"[english]Replay_PerfTip_EndOfReplayReached"	"END OF REPLAY REACHED."਍∀刀攀瀀氀愀礀开倀攀爀昀吀椀瀀开䠀椀最栀氀椀最栀琀开圀漀爀搀　∀ऀ∀䔀一吀刀䄀刀∀ഀഀ
"[english]Replay_PerfTip_Highlight_Word0"	"ENTER"਍∀刀攀瀀氀愀礀开倀攀爀昀吀椀瀀开䠀椀最栀氀椀最栀琀开圀漀爀搀㄀∀ऀ∀匀䄀䰀䤀刀∀ഀഀ
"[english]Replay_PerfTip_Highlight_Word1"	"EXIT"਍∀刀攀瀀氀愀礀开倀攀爀昀吀椀瀀开䠀椀最栀氀椀最栀琀开圀漀爀搀㈀∀ऀ∀倀唀䰀匀䄀 䔀匀倀䄀䌀䤀伀∀ഀഀ
"[english]Replay_PerfTip_Highlight_Word2"	"PRESS SPACE"਍∀刀攀瀀氀愀礀开倀攀爀昀吀椀瀀开䠀椀最栀氀椀最栀琀开圀漀爀搀㌀∀ऀ∀䌀䰀䤀䌀 䤀娀儀唀䤀䔀刀䐀伀∀ഀഀ
"[english]Replay_PerfTip_Highlight_Word3"	"LEFT-CLICK"਍∀刀攀瀀氀愀礀开倀攀爀昀吀椀瀀开䠀椀最栀氀椀最栀琀开圀漀爀搀㐀∀ऀ∀䌀伀一吀䤀一唀䄀刀∀ഀഀ
"[english]Replay_PerfTip_Highlight_Word4"	"UNPAUSE"਍∀刀攀瀀氀愀礀开倀攀爀昀吀椀瀀开䠀椀最栀氀椀最栀琀开圀漀爀搀㔀∀ऀ∀刀䔀䈀伀䈀䤀一䄀刀∀ഀഀ
"[english]Replay_PerfTip_Highlight_Word5"	"REWIND"਍∀刀攀瀀氀愀礀开倀攀爀昀吀椀瀀开䠀椀最栀氀椀最栀琀开圀漀爀搀㘀∀ऀ∀䴀䄀刀䌀䄀䐀伀刀 䐀䔀 䘀䤀一∀ഀഀ
"[english]Replay_PerfTip_Highlight_Word6"	"OUT POINT"਍∀刀攀瀀氀愀礀开倀攀爀昀吀椀瀀开䠀椀最栀氀椀最栀琀开圀漀爀搀㜀∀ऀ∀䌀伀刀吀䄀刀∀ഀഀ
"[english]Replay_PerfTip_Highlight_Word7"	"SNIP"਍∀刀攀瀀氀愀礀开倀攀爀昀吀椀瀀开䠀椀最栀氀椀最栀琀开圀漀爀搀㠀∀ऀ∀✀圀✀∀ഀഀ
"[english]Replay_PerfTip_Highlight_Word8"	"'W'"਍∀刀攀瀀氀愀礀开倀攀爀昀吀椀瀀开䠀椀最栀氀椀最栀琀开圀漀爀搀㤀∀ऀ∀✀䄀✀∀ഀഀ
"[english]Replay_PerfTip_Highlight_Word9"	"'A'"਍∀刀攀瀀氀愀礀开倀攀爀昀吀椀瀀开䠀椀最栀氀椀最栀琀开圀漀爀搀㄀　∀ऀ∀✀匀✀∀ഀഀ
"[english]Replay_PerfTip_Highlight_Word10"	"'S'"਍∀刀攀瀀氀愀礀开倀攀爀昀吀椀瀀开䠀椀最栀氀椀最栀琀开圀漀爀搀㄀㄀∀ऀ∀✀䐀✀∀ഀഀ
"[english]Replay_PerfTip_Highlight_Word11"	"'D'"਍∀刀攀瀀氀愀礀开倀攀爀昀吀椀瀀开䠀椀最栀氀椀最栀琀开圀漀爀搀㄀㈀∀ऀ∀✀娀✀∀ഀഀ
"[english]Replay_PerfTip_Highlight_Word12"	"'Z'"਍∀刀攀瀀氀愀礀开倀攀爀昀吀椀瀀开䠀椀最栀氀椀最栀琀开圀漀爀搀㄀㌀∀ऀ∀✀堀✀∀ഀഀ
"[english]Replay_PerfTip_Highlight_Word13"	"'X'"਍∀刀攀瀀氀愀礀开倀攀爀昀吀椀瀀开䠀椀最栀氀椀最栀琀开圀漀爀搀㄀㐀∀ऀ∀䴀伀嘀䔀刀 䔀䰀 刀䄀吀팀一∀ഀഀ
"[english]Replay_PerfTip_Highlight_Word14"	"MOVE THE MOUSE"਍∀刀攀瀀氀愀礀开倀攀爀昀吀椀瀀开䠀椀最栀氀椀最栀琀开圀漀爀搀㄀㔀∀ऀ∀䴀䄀刀䌀䄀䐀伀刀 䐀䔀 䤀一䤀䌀䤀伀∀ഀഀ
"[english]Replay_PerfTip_Highlight_Word15"	"IN POINT"਍∀刀攀瀀氀愀礀开倀攀爀昀吀椀瀀开䠀椀最栀氀椀最栀琀开圀漀爀搀㄀㘀∀ऀ∀刀䔀倀刀伀䐀唀䌀䤀刀∀ഀഀ
"[english]Replay_PerfTip_Highlight_Word16"	"PLAY"਍∀刀攀瀀氀愀礀开倀攀爀昀吀椀瀀开䠀椀最栀氀椀最栀琀开圀漀爀搀㄀㜀∀ऀ∀䄀嘀䄀一䌀䔀 刀섀倀䤀䐀伀∀ഀഀ
"[english]Replay_PerfTip_Highlight_Word17"	"FAST FORWARD"਍∀刀攀瀀氀愀礀开倀攀爀昀吀椀瀀开䠀椀最栀氀椀最栀琀开圀漀爀搀㄀㠀∀ऀ∀䴀䄀夀匀⸀∀ഀഀ
"[english]Replay_PerfTip_Highlight_Word18"	"SHIFT"਍∀刀攀瀀氀愀礀开倀攀爀昀吀椀瀀开䠀椀最栀氀椀最栀琀开圀漀爀搀㄀㤀∀ऀ∀䄀䰀吀∀ഀഀ
"[english]Replay_PerfTip_Highlight_Word19"	"ALT"਍∀刀攀瀀氀愀礀开倀攀爀昀吀椀瀀开䠀椀最栀氀椀最栀琀开圀漀爀搀㈀　∀ऀ∀倀刀䤀䴀䔀刀䄀 倀䔀刀匀伀一䄀∀ഀഀ
"[english]Replay_PerfTip_Highlight_Word20"	"FIRST PERSON"਍∀刀攀瀀氀愀礀开倀攀爀昀吀椀瀀开䠀椀最栀氀椀最栀琀开圀漀爀搀㈀㄀∀ऀ∀吀䔀刀䌀䔀刀䄀 倀䔀刀匀伀一䄀∀ഀഀ
"[english]Replay_PerfTip_Highlight_Word21"	"THIRD PERSON"਍∀刀攀瀀氀愀礀开倀攀爀昀吀椀瀀开䠀椀最栀氀椀最栀琀开圀漀爀搀㈀㈀∀ऀ∀䌀섀䴀䄀刀䄀 䰀䤀䈀刀䔀∀ഀഀ
"[english]Replay_PerfTip_Highlight_Word22"	"FREE CAMERA"਍∀刀攀瀀氀愀礀开倀攀爀昀吀椀瀀开䠀椀最栀氀椀最栀琀开一甀洀圀漀爀搀猀∀ऀ∀㈀㌀∀ഀഀ
"[english]Replay_PerfTip_Highlight_NumWords"	"23"਍∀刀攀瀀氀愀礀开䔀搀椀琀漀爀䈀甀琀琀漀渀吀椀瀀开䤀渀䈀甀琀琀漀渀∀ऀ∀䴀䄀刀䌀䄀䐀伀刀 䐀䔀 䤀一䤀䌀䤀伀 ⴀ 䘀䤀䨀䄀 䔀䰀 倀唀一吀伀 䐀䔀 䤀一䤀䌀䤀伀 䐀䔀 䰀䄀 吀伀䴀䄀∀ഀഀ
"[english]Replay_EditorButtonTip_InButton"	"IN POINT - SETS THE START POINT FOR THE TAKE"਍∀刀攀瀀氀愀礀开䔀搀椀琀漀爀䈀甀琀琀漀渀吀椀瀀开刀眀䠀愀爀搀䈀甀琀琀漀渀∀ऀ∀刀䔀䈀伀䈀䤀一䄀 䄀䰀 䤀一䤀䌀䤀伀 䐀䔀 䰀䄀 吀伀䴀䄀 伀尀尀一䄀䰀 䴀䄀刀䌀䄀䐀伀刀 䐀䔀 䤀一䤀䌀䤀伀Ⰰ 匀䤀 䠀䄀夀 䄀䰀䜀唀一伀 䘀䤀䨀䄀䐀伀∀ഀഀ
"[english]Replay_EditorButtonTip_RwHardButton"	"REWIND TO THE BEGINNING OF THE TAKE, OR\nTHE IN POINT IF ONE IS SET"਍∀刀攀瀀氀愀礀开䔀搀椀琀漀爀䈀甀琀琀漀渀吀椀瀀开刀眀䈀甀琀琀漀渀∀ऀ∀刀䔀䈀伀䈀䤀一䄀 ㄀　 匀䔀䜀唀一䐀伀匀∀ഀഀ
"[english]Replay_EditorButtonTip_RwButton"	"REWIND 10 SECONDS"਍∀刀攀瀀氀愀礀开䔀搀椀琀漀爀䈀甀琀琀漀渀吀椀瀀开倀氀愀礀䈀甀琀琀漀渀∀ऀ∀刀䔀倀刀伀䐀唀䌀䤀刀∀ഀഀ
"[english]Replay_EditorButtonTip_PlayButton"	"PLAY"਍∀刀攀瀀氀愀礀开䔀搀椀琀漀爀䈀甀琀琀漀渀吀椀瀀开䘀昀䈀甀琀琀漀渀∀ऀ∀䄀嘀䄀一䌀䔀 刀섀倀䤀䐀伀 ⴀ 䠀䄀娀 䌀䰀䤀䌀 夀 䴀䄀一吀준一 倀刀䔀匀䤀伀一䄀䐀伀 䔀䰀 䈀伀吀팀一 䤀娀儀唀䤀䔀刀䐀伀 䐀䔀䰀 刀䄀吀팀一尀尀一 ⨀ 倀唀䰀匀䄀 夀 䴀䄀一吀준一 䴀䄀夀匀⸀ 倀䄀刀䄀 唀一 䄀嘀䄀一䌀䔀 䰀䔀一吀伀尀尀一 ⨀ 倀唀䰀匀䄀 夀 䴀䄀一吀준一 䄀䰀吀 倀䄀刀䄀 唀一 䄀嘀䄀一䌀䔀 䄀一 䴀섀匀 刀섀倀䤀䐀伀∀ഀഀ
"[english]Replay_EditorButtonTip_FfButton"	"FAST FORWARD - CLICK AND HOLD THE LEFT MOUSE BUTTON\n * HOLD SHIFT TO FAST FORWARD SLOWLY\n * HOLD ALT TO FAST FORWARD QUICKLY"਍∀刀攀瀀氀愀礀开䔀搀椀琀漀爀䈀甀琀琀漀渀吀椀瀀开䘀昀䠀愀爀搀䈀甀琀琀漀渀∀ऀ∀䄀嘀䄀一娀䄀 刀섀倀䤀䐀䄀䴀䔀一吀䔀 䄀䰀 䘀䤀一䄀䰀 䐀䔀 䰀䄀 䜀刀䄀䈀䄀䌀䤀팀一 伀 䄀䰀尀尀一䴀䄀刀䌀䄀䐀伀刀 䐀䔀 䘀䤀一Ⰰ 匀䤀 䠀䄀夀 䄀䰀䜀唀一伀 䘀䤀䨀䄀䐀伀∀ഀഀ
"[english]Replay_EditorButtonTip_FfHardButton"	"FAST FORWARD TO THE END OF THE REPLAY OR THE\nOUT POINT, IF ONE IS SET"਍∀刀攀瀀氀愀礀开䔀搀椀琀漀爀䈀甀琀琀漀渀吀椀瀀开伀甀琀䈀甀琀琀漀渀∀ऀ∀䴀䄀刀䌀䄀䐀伀刀 䐀䔀 䘀䤀一 ⴀ 䘀䤀䨀䄀 䔀䰀 䘀䤀一䄀䰀 䐀䔀 䰀䄀 吀伀䴀䄀∀ഀഀ
"[english]Replay_EditorButtonTip_OutButton"	"OUT POINT - SETS THE END POINT FOR THE TAKE"਍∀刀攀瀀氀愀礀开䔀搀椀琀漀爀䈀甀琀琀漀渀吀椀瀀开䘀椀爀猀琀倀攀爀猀漀渀䈀甀琀琀漀渀∀ऀ∀䌀섀䴀䄀刀䄀 䐀䔀 倀刀䤀䴀䔀刀䄀 倀䔀刀匀伀一䄀∀ഀഀ
"[english]Replay_EditorButtonTip_FirstPersonButton"	"FIRST PERSON CAMERA"਍∀刀攀瀀氀愀礀开䔀搀椀琀漀爀䈀甀琀琀漀渀吀椀瀀开吀栀椀爀搀倀攀爀猀漀渀䈀甀琀琀漀渀∀ऀ∀䌀섀䴀䄀刀䄀 䐀䔀 吀䔀刀䌀䔀刀䄀 倀䔀刀匀伀一䄀∀ഀഀ
"[english]Replay_EditorButtonTip_ThirdPersonButton"	"THIRD PERSON CAMERA"਍∀刀攀瀀氀愀礀开䔀搀椀琀漀爀䈀甀琀琀漀渀吀椀瀀开䘀爀攀攀䌀愀洀䈀甀琀琀漀渀∀ऀ∀䌀섀䴀䄀刀䄀 䰀䤀䈀刀䔀∀ഀഀ
"[english]Replay_EditorButtonTip_FreeCamButton"	"FREE CAMERA"਍∀刀攀瀀氀愀礀开䔀搀椀琀漀爀䈀甀琀琀漀渀吀椀瀀开吀椀洀攀匀挀愀氀攀䈀甀琀琀漀渀∀ऀ∀刀䄀䰀䔀一吀䤀娀䄀刀 伀 䄀䌀䔀䰀䔀刀䄀刀 䔀䰀 吀䤀䔀䴀倀伀∀ഀഀ
"[english]Replay_EditorButtonTip_TimeScaleButton"	"SLOW DOWN OR SPEED UP TIME"਍∀刀攀瀀氀愀礀开䌀氀椀攀渀琀匀椀搀攀䐀椀猀愀戀氀攀搀∀ऀ∀䰀䄀 䜀刀䄀䈀䄀䌀䤀팀一 䠀䄀 匀䤀䐀伀 䐀䔀匀䄀䌀吀䤀嘀䄀䐀䄀 䐀䔀䈀䤀䐀伀 䄀 唀一 䌀伀䴀倀伀刀吀䄀䴀䤀䔀一吀伀 䤀一䔀匀倀䔀刀䄀䐀伀 䐀䔀䰀 匀䔀刀嘀䤀䐀伀刀⸀∀ഀഀ
"[english]Replay_ClientSideDisabled"	"REPLAY HAS BEEN DISABLED DUE TO UNEXPECTED SERVER BEHAVIOR."਍∀刀攀瀀氀愀礀开䌀氀椀攀渀琀匀椀搀攀䔀渀愀戀氀攀搀∀ऀ∀䰀䄀 䜀刀䄀䈀䄀䌀䤀팀一 匀䔀 䠀䄀 刀䔀䌀唀倀䔀刀䄀䐀伀 䐀䔀 唀一 䌀伀䴀倀伀刀吀䄀䴀䤀䔀一吀伀 䤀一䔀匀倀䔀刀䄀䐀伀 䐀䔀䰀 匀䔀刀嘀䤀䐀伀刀⸀∀ഀഀ
"[english]Replay_ClientSideEnabled"	"REPLAY HAS RECOVERED FROM UNEXPECTED SERVER BEHAVIOR."਍∀刀攀瀀氀愀礀开䐀䰀开䔀爀爀开匀䤀开一漀匀攀猀猀椀漀渀一愀洀攀∀ऀ∀一漀 猀攀 栀愀 攀猀瀀攀挀椀昀椀挀愀搀漀 攀氀 渀漀洀戀爀攀 搀攀 猀攀猀椀渀 攀渀 攀氀 愀爀挀栀椀瘀漀 搀攀 椀渀昀漀爀洀愀挀椀渀 搀攀 氀愀 猀攀猀椀渀⸀∀ഀഀ
"[english]Replay_DL_Err_SI_NoSessionName"	"No session name in session info file."਍∀刀攀瀀氀愀礀开䐀䰀开䔀爀爀开匀䤀开刀攀瀀氀愀礀一漀琀䘀漀甀渀搀∀ऀ∀一漀 猀攀 栀愀 攀渀挀漀渀琀爀愀搀漀 氀愀 最爀愀戀愀挀椀渀 攀渀 攀氀 愀爀挀栀椀瘀漀 搀攀 椀渀昀漀爀洀愀挀椀渀 搀攀 氀愀 猀攀猀椀渀⸀∀ഀഀ
"[english]Replay_DL_Err_SI_ReplayNotFound"	"Replay not found in session info file."਍∀刀攀瀀氀愀礀开䐀䰀开䔀爀爀开匀䤀开䤀渀瘀愀氀椀搀刀攀瀀氀愀礀匀琀愀琀甀猀∀ऀ∀䔀猀琀愀搀漀 搀攀 最爀愀戀愀挀椀渀 椀渀挀漀爀爀攀挀琀漀 攀渀 攀氀 愀爀挀栀椀瘀漀 搀攀 椀渀昀漀爀洀愀挀椀渀 搀攀 氀愀 猀攀猀椀渀⸀∀ഀഀ
"[english]Replay_DL_Err_SI_InvalidReplayStatus"	"Invalid replay status in session info file."਍∀刀攀瀀氀愀礀开䐀䰀开䔀爀爀开匀䤀开䤀渀瘀愀氀椀搀伀爀搀攀爀∀ऀ∀伀爀搀攀渀 搀攀 戀氀漀焀甀攀 渀漀 瘀氀椀搀漀 攀渀 攀氀 愀爀挀栀椀瘀漀 搀攀 椀渀昀漀爀洀愀挀椀渀 搀攀 氀愀 猀攀猀椀渀⸀∀ഀഀ
"[english]Replay_DL_Err_SI_InvalidOrder"	"Invalid block order in session info file."਍∀刀攀瀀氀愀礀开䐀䰀开䔀爀爀开匀䤀开唀渀欀渀漀眀渀∀ऀ∀䔀爀爀漀爀 搀攀猀挀漀渀漀挀椀搀漀 愀氀 搀攀猀挀愀爀最愀爀 礀 瀀爀漀挀攀猀愀爀 攀氀 愀爀挀栀椀瘀漀 搀攀 椀渀昀漀爀洀愀挀椀渀 搀攀 氀愀 猀攀猀椀渀⸀∀ഀഀ
"[english]Replay_DL_Err_SI_Unknown"	"The session file failed to download and process due to an unknown error."਍∀刀攀瀀氀愀礀开䐀䰀开䔀爀爀开匀䤀开䈀氀漀挀欀刀攀愀搀䘀愀椀氀攀搀∀ऀ∀一漀 猀攀 瀀甀搀漀 氀攀攀爀 攀氀 戀氀漀焀甀攀 搀攀 猀攀猀椀渀 搀攀 戀切昀攀爀 搀攀猀挀愀爀最愀搀漀⸀∀ഀഀ
"[english]Replay_DL_Err_SI_BlockReadFailed"	"Could not read from downloaded session block buffer."਍∀刀攀瀀氀愀礀开䐀䰀开䔀爀爀开匀䤀开一漀琀䔀渀漀甀最栀䐀愀琀愀∀ऀ∀䔀氀 愀爀挀栀椀瘀漀 搀攀 椀渀昀漀爀洀愀挀椀渀 搀攀 氀愀 猀攀猀椀渀 猀攀 搀攀猀挀愀爀最Ⰰ 瀀攀爀漀 渀漀 挀漀渀琀椀攀渀攀 搀愀琀漀猀 猀甀昀椀挀椀攀渀琀攀猀 挀漀洀漀 瀀愀爀愀 最攀渀攀爀愀爀 甀渀 攀渀挀愀戀攀稀愀搀漀⸀∀ഀഀ
"[english]Replay_DL_Err_SI_NotEnoughData"	"The session info file downloaded but did not have enough data to constitute a header."਍∀刀攀瀀氀愀礀开䐀䰀开䔀爀爀开匀䤀开䌀漀甀氀搀一漀琀䌀爀攀愀琀攀䌀漀洀瀀爀攀猀猀漀爀∀ऀ∀䔀氀 搀攀猀挀愀爀最愀搀漀爀 搀攀 氀愀 椀渀昀漀爀洀愀挀椀渀 搀攀 氀愀 猀攀猀椀渀 渀漀 栀愀 瀀漀搀椀搀漀 挀爀攀愀爀 攀氀 挀漀洀瀀爀攀猀漀爀 攀猀瀀攀挀椀昀椀挀愀搀漀 瀀漀爀焀甀攀 攀猀琀攀 攀爀愀 椀渀瘀氀椀搀漀⸀∀ഀഀ
"[english]Replay_DL_Err_SI_CouldNotCreateCompressor"	"Session info downloader could not create the specified compressor because it was invalid."਍∀刀攀瀀氀愀礀开䐀䰀开䔀爀爀开匀䤀开䤀渀瘀愀氀椀搀唀渀挀漀洀瀀爀攀猀猀攀搀匀椀稀攀∀ऀ∀䰀愀 椀渀昀漀爀洀愀挀椀渀 搀攀 氀愀 猀攀猀椀渀 搀攀猀挀愀爀最愀搀愀 栀愀 攀猀瀀攀挀椀昀椀挀愀搀漀 甀渀 琀愀洀愀漀 搀攀 挀愀爀最愀 切琀椀氀 椀渀瘀氀椀搀漀⸀∀ഀഀ
"[english]Replay_DL_Err_SI_InvalidUncompressedSize"	"The session info downloaded specified an invalid uncompressed payload size."਍∀刀攀瀀氀愀礀开䐀䰀开䔀爀爀开匀䤀开倀愀礀氀漀愀搀䐀攀挀漀洀瀀爀攀猀猀䘀愀椀氀攀搀∀ऀ∀䔀爀爀漀爀 愀氀 搀攀猀挀漀洀瀀爀椀洀椀爀 氀愀 挀愀爀最愀 切琀椀氀 搀攀 氀愀 椀渀昀漀爀洀愀挀椀渀 搀攀 氀愀 猀攀猀椀渀⸀∀ഀഀ
"[english]Replay_DL_Err_SI_PayloadDecompressFailed"	"Session info payload decompression failed."਍∀刀攀瀀氀愀礀开䐀䰀开䔀爀爀开匀䤀开倀愀礀氀漀愀搀䠀愀猀栀䘀愀椀氀攀搀∀ऀ∀䰀愀 挀愀爀最愀 切琀椀氀 搀攀氀 栀愀猀栀 搀攀 氀愀 椀渀昀漀爀洀愀挀椀渀 搀攀 猀攀猀椀渀 攀爀愀 椀渀瘀氀椀搀漀⸀∀ഀഀ
"[english]Replay_DL_Err_SI_PayloadHashFailed"	"Session info payload hash was invalid."਍∀刀攀瀀氀愀礀开䐀䰀开䔀爀爀开匀䤀开唀渀欀渀漀眀渀开匀攀猀猀椀漀渀∀ऀ∀䔀氀 渀搀椀挀攀 搀攀 搀攀猀挀愀爀最愀猀 搀攀氀 猀攀爀瘀椀搀漀爀 栀愀挀攀 爀攀昀攀爀攀渀挀椀愀 愀 甀渀愀 猀攀猀椀渀 焀甀攀 渀漀 攀砀椀猀琀攀 攀渀 攀氀 挀氀椀攀渀琀攀⸀∀ഀഀ
"[english]Replay_DL_Err_SI_Unknown_Session"	"The downloaded server index refers to a session that doesn't exist on the client."਍∀刀攀瀀氀愀礀开䐀䰀开䔀爀爀开匀䤀开䐀漀眀渀氀漀愀搀䘀愀椀氀攀搀开唀渀欀渀漀眀渀䔀爀爀漀爀∀ऀ∀䔀爀爀漀爀 愀氀 搀攀猀挀愀爀最愀爀 攀氀 愀爀挀栀椀瘀漀 搀攀 椀渀昀漀爀洀愀挀椀渀 搀攀 氀愀 猀攀猀椀渀㨀 䔀爀爀漀爀 搀攀猀挀漀渀漀挀椀搀漀⸀ 唀刀䰀㨀 ─甀爀氀─∀ഀഀ
"[english]Replay_DL_Err_SI_DownloadFailed_UnknownError"	"The session info file failed to download: Unknown error.  URL: %url%"਍∀刀攀瀀氀愀礀开䐀䰀开䔀爀爀开匀䤀开䐀漀眀渀氀漀愀搀䘀愀椀氀攀搀开娀攀爀漀䰀攀渀最琀栀䘀椀氀攀∀ऀ∀䔀爀爀漀爀 愀氀 搀攀猀挀愀爀最愀爀 攀氀 愀爀挀栀椀瘀漀 搀攀 椀渀昀漀爀洀愀挀椀渀 搀攀 氀愀 猀攀猀椀渀㨀 䄀爀挀栀椀瘀漀 搀攀 氀漀渀最椀琀甀搀 挀攀爀漀⸀ 唀刀䰀㨀 ─甀爀氀─∀ഀഀ
"[english]Replay_DL_Err_SI_DownloadFailed_ZeroLengthFile"	"The session info file failed to download: Zero length file.  URL: %url%"਍∀刀攀瀀氀愀礀开䐀䰀开䔀爀爀开匀䤀开䐀漀眀渀氀漀愀搀䘀愀椀氀攀搀开䌀漀渀渀攀挀琀椀漀渀䌀氀漀猀攀搀∀ऀ∀䔀爀爀漀爀 愀氀 搀攀猀挀愀爀最愀爀 攀氀 愀爀挀栀椀瘀漀 搀攀 椀渀昀漀爀洀愀挀椀渀 搀攀 氀愀 猀攀猀椀渀㨀 䌀漀渀攀砀椀渀 挀攀爀爀愀搀愀⸀ 唀刀䰀㨀 ─甀爀氀─∀ഀഀ
"[english]Replay_DL_Err_SI_DownloadFailed_ConnectionClosed"	"The session info file failed to download: Connection closed.  URL: %url%"਍∀刀攀瀀氀愀礀开䐀䰀开䔀爀爀开匀䤀开䐀漀眀渀氀漀愀搀䘀愀椀氀攀搀开䤀渀瘀愀氀椀搀唀刀䰀∀ऀ∀䔀爀爀漀爀 愀氀 搀攀猀挀愀爀最愀爀 攀氀 愀爀挀栀椀瘀漀 搀攀 椀渀昀漀爀洀愀挀椀渀 搀攀 氀愀 猀攀猀椀渀㨀 唀刀䰀 渀漀 瘀氀椀搀漀⸀ 唀刀䰀㨀 ─甀爀氀─∀ഀഀ
"[english]Replay_DL_Err_SI_DownloadFailed_InvalidURL"	"The session info file failed to download: Invalid URL.  URL: %url%"਍∀刀攀瀀氀愀礀开䐀䰀开䔀爀爀开匀䤀开䐀漀眀渀氀漀愀搀䘀愀椀氀攀搀开䤀渀瘀愀氀椀搀倀爀漀琀漀挀漀氀∀ऀ∀䔀爀爀漀爀 愀氀 搀攀猀挀愀爀最愀爀 攀氀 愀爀挀栀椀瘀漀 搀攀 椀渀昀漀爀洀愀挀椀渀 搀攀 氀愀 猀攀猀椀渀㨀 倀爀漀琀漀挀漀氀漀 渀漀 瘀氀椀搀漀⸀ 唀刀䰀㨀 ─甀爀氀─∀ഀഀ
"[english]Replay_DL_Err_SI_DownloadFailed_InvalidProtocol"	"The session info file failed to download: Invalid protocol.  URL: %url%"਍∀刀攀瀀氀愀礀开䐀䰀开䔀爀爀开匀䤀开䐀漀眀渀氀漀愀搀䘀愀椀氀攀搀开䌀愀渀琀䈀椀渀搀匀漀挀欀攀琀∀ऀ∀䔀爀爀漀爀 愀氀 搀攀猀挀愀爀最愀爀 攀氀 愀爀挀栀椀瘀漀 搀攀 椀渀昀漀爀洀愀挀椀渀 搀攀 氀愀 猀攀猀椀渀㨀 一漀 猀攀 栀愀 瀀漀搀椀搀漀 愀猀漀挀椀愀爀 攀氀 猀漀挀欀攀琀⸀ 唀刀䰀㨀 ─甀爀氀─∀ഀഀ
"[english]Replay_DL_Err_SI_DownloadFailed_CantBindSocket"	"The session info file failed to download: Can't bind socket.  URL: %url%"਍∀刀攀瀀氀愀礀开䐀䰀开䔀爀爀开匀䤀开䐀漀眀渀氀漀愀搀䘀愀椀氀攀搀开䌀愀渀琀䌀漀渀渀攀挀琀∀ऀ∀䔀爀爀漀爀 愀氀 搀攀猀挀愀爀最愀爀 攀氀 愀爀挀栀椀瘀漀 搀攀 椀渀昀漀爀洀愀挀椀渀 搀攀 氀愀 猀攀猀椀渀㨀 一漀 猀攀 栀愀 瀀漀搀椀搀漀 攀猀琀愀戀氀攀挀攀爀 氀愀 挀漀渀攀砀椀渀⸀ 唀刀䰀㨀 ─甀爀氀─∀ഀഀ
"[english]Replay_DL_Err_SI_DownloadFailed_CantConnect"	"The session info file failed to download: Can't connect.  URL: %url%"਍∀刀攀瀀氀愀礀开䐀䰀开䔀爀爀开匀䤀开䐀漀眀渀氀漀愀搀䘀愀椀氀攀搀开一漀䠀攀愀搀攀爀猀∀ऀ∀䔀爀爀漀爀 愀氀 搀攀猀挀愀爀最愀爀 攀氀 愀爀挀栀椀瘀漀 搀攀 椀渀昀漀爀洀愀挀椀渀 搀攀 氀愀 猀攀猀椀渀㨀 一漀 栀愀礀 攀渀挀愀戀攀稀愀洀椀攀渀琀漀猀⸀ 唀刀䰀㨀 ─甀爀氀─∀ഀഀ
"[english]Replay_DL_Err_SI_DownloadFailed_NoHeaders"	"The session info file failed to download: No headers.  URL: %url%"਍∀刀攀瀀氀愀礀开䐀䰀开䔀爀爀开匀䤀开䐀漀眀渀氀漀愀搀䘀愀椀氀攀搀开䘀椀氀攀一漀渀䔀砀椀猀琀攀渀琀∀ऀ∀䔀爀爀漀爀 愀氀 搀攀猀挀愀爀最愀爀 攀氀 愀爀挀栀椀瘀漀 搀攀 椀渀昀漀爀洀愀挀椀渀 搀攀 氀愀 猀攀猀椀渀㨀 䄀爀挀栀椀瘀漀 椀渀攀砀椀猀琀攀渀琀攀⸀ 唀刀䰀㨀 ─甀爀氀─∀ഀഀ
"[english]Replay_DL_Err_SI_DownloadFailed_FileNonExistent"	"The session info file failed to download: File non-existent.  URL: %url%"਍∀刀攀瀀氀愀礀开䐀䰀开䔀爀爀开䠀吀吀倀开倀爀攀昀椀砀∀ऀ∀䰀愀 搀攀猀挀愀爀最愀 搀攀 氀愀 最爀愀戀愀挀椀渀 昀愀氀氀 瀀漀爀 氀愀 猀椀最甀椀攀渀琀攀 爀愀稀渀㨀 ─攀爀爀─∀ഀഀ
"[english]Replay_DL_Err_HTTP_Prefix"	"Replay download failed for the following reason: %err%"਍∀刀攀瀀氀愀礀开䐀䰀开䔀爀爀开匀䤀开倀爀攀昀椀砀∀ऀ∀䔀氀 愀爀挀栀椀瘀漀 搀攀 椀渀昀漀爀洀愀挀椀渀 搀攀 氀愀 猀攀猀椀渀 渀漀 猀攀 瀀甀搀漀 搀攀猀挀愀爀最愀爀 瀀漀爀 攀氀 猀椀最甀椀攀渀琀攀 洀漀琀椀瘀漀㨀 ─攀爀爀─∀ഀഀ
"[english]Replay_DL_Err_SI_Prefix"	"Replay session info file failed to download the following reason: %err%"਍∀刀攀瀀氀愀礀开䔀爀爀开刀攀瀀漀爀琀开倀爀攀昀椀砀∀ऀ∀唀渀漀 漀 洀猀 攀爀爀漀爀攀猀 栀愀渀 漀挀甀爀爀椀搀漀㨀尀渀尀渀∀ഀഀ
"[english]Replay_Err_Report_Prefix"	"One or more replay errors have occurred:\n\n"਍∀刀攀瀀氀愀礀开䔀爀爀开匀攀猀猀椀漀渀䤀渀昀漀开䈀愀搀匀攀猀猀椀漀渀一愀洀攀∀ऀ∀一漀洀戀爀攀 搀攀 猀攀猀椀渀 椀渀挀漀爀爀攀挀琀漀 攀渀 氀愀 椀渀昀漀爀洀愀挀椀渀 搀攀 氀愀 猀攀猀椀漀渀⸀∀ഀഀ
"[english]Replay_Err_SessionInfo_BadSessionName"	"Bad session name in session info."਍∀刀攀瀀氀愀礀开䔀爀爀开匀攀猀猀椀漀渀䤀渀昀漀开䈀愀搀䐀甀洀瀀䤀渀琀攀爀瘀愀氀∀ऀ∀䤀渀琀攀爀瘀愀氀漀 搀攀 瘀漀氀挀愀搀漀 攀爀爀渀攀漀 攀渀 氀愀 椀渀昀漀爀洀愀挀椀渀 搀攀 氀愀 猀攀猀椀渀⸀∀ഀഀ
"[english]Replay_Err_SessionInfo_BadDumpInterval"	"Bad dump interval in session info."਍∀刀攀瀀氀愀礀开䔀爀爀开匀攀猀猀椀漀渀䤀渀昀漀开䈀愀搀䌀甀爀爀攀渀琀䈀氀漀挀欀∀ऀ∀촀渀搀椀挀攀 搀攀 戀氀漀焀甀攀猀 攀爀爀渀攀漀 攀渀 氀愀 椀渀昀漀爀洀愀挀椀渀 搀攀 氀愀 猀攀猀椀渀⸀∀ഀഀ
"[english]Replay_Err_SessionInfo_BadCurrentBlock"	"Bad block index in session info."਍∀刀攀瀀氀愀礀开䔀爀爀开匀攀猀猀椀漀渀䤀渀昀漀开䈀愀搀匀琀愀爀琀吀椀挀欀∀ऀ∀䴀愀爀挀愀 搀攀 椀渀椀挀椀漀 攀爀爀渀攀愀 攀渀 氀愀 椀渀昀漀爀洀愀挀椀渀 搀攀 氀愀 猀攀猀椀渀⸀∀ഀഀ
"[english]Replay_Err_SessionInfo_BadStartTick"	"Bad start tick in session info."਍∀刀攀瀀氀愀礀开䔀爀爀开刀攀挀漀渀开䘀愀椀氀∀ऀ∀䔀爀爀漀爀 攀渀 氀愀 爀攀挀漀渀猀琀爀甀挀挀椀渀⸀ 䤀洀瀀漀猀椀戀氀攀 爀攀瀀爀漀搀甀挀椀爀 氀愀 最爀愀戀愀挀椀渀⸀∀ഀഀ
"[english]Replay_Err_Recon_Fail"	"Reconstruction failed.  Unable to play replay."਍∀刀攀瀀氀愀礀开䔀爀爀开刀攀挀漀渀开䈀愀搀匀攀猀猀椀漀渀∀ऀ∀䰀愀 最爀愀戀愀挀椀渀 愀瀀甀渀琀愀 愀 甀渀愀 猀攀猀椀渀 渀漀 攀砀椀猀琀攀渀琀攀⸀∀ഀഀ
"[english]Replay_Err_Recon_BadSession"	"Replay points to a non-existent session."਍∀刀攀瀀氀愀礀开䔀爀爀开刀攀挀漀渀开一漀琀䔀渀漀甀最栀䈀氀漀挀欀猀∀ऀ∀一漀 栀愀礀 猀甀昀椀挀椀攀渀琀攀猀 戀氀漀焀甀攀猀 瀀愀爀愀 氀愀 爀攀挀漀渀猀琀爀甀挀挀椀渀⸀∀ഀഀ
"[english]Replay_Err_Recon_NotEnoughBlocks"	"Not enough blocks for reconstruction."਍∀刀攀瀀氀愀礀开䔀爀爀开刀攀挀漀渀开䈀氀漀挀欀猀一漀琀䐀䰀搀∀ऀ∀一漀 猀攀 搀攀猀挀愀爀最愀爀漀渀 琀漀搀漀猀 氀漀猀 戀氀漀焀甀攀猀 搀攀 氀愀 猀攀猀椀渀⸀∀ഀഀ
"[english]Replay_Err_Recon_BlocksNotDLd"	"Not all session blocks were downloaded."਍∀刀攀瀀氀愀礀开䔀爀爀开刀攀挀漀渀开一漀渀䌀漀渀琀椀渀甀漀甀猀∀ऀ∀䰀椀猀琀愀 搀椀猀挀漀渀琀椀渀甀愀 搀攀 渀搀椀挀攀猀 搀攀 爀攀挀漀渀猀琀甀挀挀椀渀⸀∀ഀഀ
"[english]Replay_Err_Recon_NonContinuous"	"Non-continuous list of reconstruction indices."਍∀刀攀瀀氀愀礀开䔀爀爀开刀攀挀漀渀开䈀氀漀挀欀䐀一䔀∀ऀ∀唀渀漀 漀 洀猀 戀氀漀焀甀攀猀 搀攀 氀愀 猀攀猀椀渀 渀漀 攀砀椀猀琀攀渀 攀渀 攀氀 搀椀猀挀漀⸀∀ഀഀ
"[english]Replay_Err_Recon_BlockDNE"	"One or more session blocks do not exist on disk."਍∀刀攀瀀氀愀礀开䔀爀爀开刀攀挀漀渀开娀攀爀漀䰀攀渀最琀栀䈀氀漀挀欀∀ऀ∀䈀氀漀焀甀攀 搀攀 猀攀猀椀渀 搀攀 氀漀渀最椀琀甀搀 挀攀爀漀⸀∀ഀഀ
"[english]Replay_Err_Recon_ZeroLengthBlock"	"Zero-length session block."਍∀刀攀瀀氀愀礀开䔀爀爀开刀攀挀漀渀开伀甀琀伀昀䴀攀洀漀爀礀∀ऀ∀匀攀 愀挀愀戀 氀愀 洀攀洀漀爀椀愀⸀∀ഀഀ
"[english]Replay_Err_Recon_OutOfMemory"	"Ran out of memory."਍∀刀攀瀀氀愀礀开䔀爀爀开刀攀挀漀渀开䘀愀椀氀攀搀吀漀刀攀愀搀∀ऀ∀䔀爀爀漀爀 愀氀 氀攀攀爀 攀氀 戀氀漀焀甀攀 搀攀 氀愀 猀攀猀椀渀⸀∀ഀഀ
"[english]Replay_Err_Recon_FailedToRead"	"Failed to read session block."਍∀刀攀瀀氀愀礀开䔀爀爀开刀攀挀漀渀开䘀愀椀氀攀搀吀漀圀爀椀琀攀∀ऀ∀䔀爀爀漀爀 愀氀 攀猀挀爀椀戀椀爀 氀愀 爀攀挀漀渀猀琀爀甀挀挀椀渀 昀椀渀愀氀 搀攀 氀愀 最爀愀戀愀挀椀渀 攀渀 攀氀 搀椀猀挀漀⸀∀ഀഀ
"[english]Replay_Err_Recon_FailedToWrite"	"Failed to write the final reconstructed replay to disk."਍∀刀攀瀀氀愀礀开䔀爀爀开刀攀挀漀渀开䄀氀氀漀挀∀ऀ∀匀攀 愀挀愀戀 氀愀 洀攀洀漀爀椀愀⸀∀ഀഀ
"[english]Replay_Err_Recon_Alloc"	"Ran out of memory."਍∀刀攀瀀氀愀礀开䔀爀爀开刀攀挀漀渀开䐀攀挀漀洀瀀爀攀猀猀椀漀渀∀ऀ∀䔀爀爀漀爀 愀氀 搀攀猀挀漀洀瀀爀椀洀椀爀 攀氀 戀氀漀焀甀攀⸀∀ഀഀ
"[english]Replay_Err_Recon_Decompression"	"Failed to decompress block."਍∀刀攀瀀氀愀礀开䔀爀爀开刀攀挀漀渀开伀瀀攀渀伀甀琀䘀椀氀攀∀ऀ∀䔀爀爀漀爀 愀氀 愀戀爀椀爀 攀氀 愀爀挀栀椀瘀漀 爀攀猀甀氀琀愀渀琀攀 瀀愀爀愀 氀愀 爀攀挀漀渀猀琀爀甀挀挀椀渀⸀∀ഀഀ
"[english]Replay_Err_Recon_OpenOutFile"	"Failed to open output file for reconstruction."਍∀刀攀瀀氀愀礀开䔀爀爀开刀攀挀漀渀开䐀攀挀漀洀瀀爀攀猀猀漀爀䌀爀攀愀琀攀∀ऀ∀䔀爀爀漀爀 愀氀 挀爀攀愀爀 攀氀 搀攀猀挀漀洀瀀爀攀猀漀爀⸀∀ഀഀ
"[english]Replay_Err_Recon_DecompressorCreate"	"Failed to create decompressor."਍∀刀攀瀀氀愀礀开䔀爀爀开刀攀挀漀渀开唀渀挀漀洀瀀爀攀猀猀攀搀匀椀稀攀䤀猀娀攀爀漀∀ऀ∀䔀氀 琀愀洀愀漀 搀攀氀 愀爀挀栀椀瘀漀 搀攀猀挀漀洀瀀爀椀洀椀搀漀 渀漀 攀猀 瘀氀椀搀漀⸀∀ഀഀ
"[english]Replay_Err_Recon_UncompressedSizeIsZero"	"Uncompressed size is invalid."਍∀刀攀瀀氀愀礀开䔀爀爀开䰀漀愀搀开䈀愀搀䈀氀漀挀欀䠀愀渀搀氀攀猀∀ऀ∀唀渀愀 猀攀猀椀渀 搀攀 最爀愀戀愀挀椀渀 渀漀 瀀甀搀漀 猀攀爀 挀愀爀最愀搀愀 猀愀琀椀猀昀愀挀琀漀爀椀愀洀攀渀琀攀 瀀漀爀焀甀攀 攀氀 爀愀渀最漀 搀攀 洀愀渀椀瀀甀氀愀挀椀渀 搀攀 戀氀漀焀甀攀 渀漀 攀爀愀 瘀氀椀搀漀⸀∀ഀഀ
"[english]Replay_Err_Load_BadBlockHandles"	"A recording session was not loaded properly because block handle range was invalid."਍∀刀攀瀀氀愀礀开䔀爀爀开䰀漀愀搀开䌀漀甀氀搀一漀琀䘀椀渀搀匀攀猀猀椀漀渀∀ऀ∀䔀氀 戀氀漀焀甀攀 搀攀 氀愀 猀攀猀椀渀 栀愀挀攀 爀攀昀攀爀攀渀挀椀愀 愀 甀渀愀 猀攀猀椀渀 搀攀 最爀愀戀愀挀椀渀 焀甀攀 渀漀 栀愀 瀀漀搀椀搀漀 攀渀挀漀渀琀爀愀爀猀攀⸀∀ഀഀ
"[english]Replay_Err_Load_CouldNotFindSession"	"A recording session block referred to a recording session which could not be found."਍∀刀攀瀀氀愀礀开䔀爀爀开䰀漀愀搀开䈀愀搀伀眀渀攀爀匀攀猀猀椀漀渀∀ऀ∀一漀 猀攀 瀀甀搀漀 攀渀挀漀渀琀爀愀爀 氀愀 猀攀猀椀渀 搀攀 氀愀 最爀愀戀愀挀椀渀⸀∀ഀഀ
"[english]Replay_Err_Load_BadOwnerSession"	"Owning session for replay could not be found."਍∀刀攀瀀氀愀礀开䔀爀爀开刀攀渀搀攀爀开刀攀挀漀渀猀琀爀甀挀琀䘀愀椀氀攀搀∀ऀ∀一漀 猀攀 栀愀 瀀漀搀椀搀漀 挀漀渀瘀攀爀琀椀爀 氀愀 最爀愀戀愀挀椀渀 攀渀 甀渀 瘀椀搀攀漀 ⴀ 攀爀爀漀爀 愀氀 爀攀挀漀渀猀琀爀甀椀爀 氀愀 最爀愀戀愀挀椀渀 愀 瀀愀爀琀椀爀 搀攀 氀漀猀 戀氀漀焀甀攀猀 搀攀 氀愀 猀攀猀椀渀⸀∀ഀഀ
"[english]Replay_Err_Render_ReconstructFailed"	"Can't save replay as movie - failed to reconstruct replay from session blocks."਍∀刀攀瀀氀愀礀开䔀爀爀开一漀琀䔀渀漀甀最栀䈀氀漀挀欀猀䘀漀爀刀攀挀漀渀猀琀爀甀挀琀椀漀渀∀ऀ∀一漀 栀愀礀 猀甀昀椀挀椀攀渀琀攀猀 戀氀漀焀甀攀猀 瀀愀爀愀 爀攀挀漀渀猀琀爀甀椀爀 氀愀 最爀愀戀愀挀椀渀⸀∀ഀഀ
"[english]Replay_Err_NotEnoughBlocksForReconstruction"	"Not enough blocks for replay reconstruction."਍∀刀攀瀀氀愀礀开䔀爀爀开唀猀攀爀开䘀愀椀氀攀搀吀漀倀氀愀礀刀攀瀀氀愀礀∀ऀ∀䔀爀爀漀爀 愀氀 挀愀爀最愀爀 氀愀 最爀愀戀愀挀椀渀⸀ 䌀漀渀猀甀氀琀愀 氀愀 挀漀渀猀漀氀愀 瀀愀爀愀 挀漀渀漀挀攀爀 氀漀猀 搀攀琀愀氀氀攀猀⸀∀ഀഀ
"[english]Replay_Err_User_FailedToPlayReplay"	"The replay failed to load.  Please see the console for details."਍∀刀攀瀀氀愀礀开䔀爀爀开唀猀攀爀开䘀愀椀氀攀搀吀漀倀氀愀礀吀愀欀攀∀ऀ∀䔀爀爀漀爀 愀氀 挀愀爀最愀爀 氀愀 琀漀洀愀⸀ 䌀漀渀猀甀氀琀愀 氀愀 挀漀渀猀漀氀愀 瀀愀爀愀 挀漀渀漀挀攀爀 氀漀猀 搀攀琀愀氀氀攀猀⸀∀ഀഀ
"[english]Replay_Err_User_FailedToPlayTake"	"The take failed to load.  Please see the console for details."਍∀刀攀瀀氀愀礀开一漀唀渀爀攀渀搀攀爀攀搀刀攀瀀氀愀礀猀∀ऀ∀吀漀搀愀猀 氀愀猀 最爀愀戀愀挀椀漀渀攀猀 琀攀洀瀀漀爀愀氀攀猀 礀愀 栀愀渀 猀椀搀漀 最甀愀爀搀愀搀愀猀 挀漀洀漀 瀀攀氀挀甀氀愀猀⸀∀ഀഀ
"[english]Replay_NoUnrenderedReplays"	"All temporary replays have already been saved as movies."਍∀刀攀瀀氀愀礀开一攀攀搀儀甀椀挀欀琀椀洀攀一攀眀攀爀∀ऀ∀倀愀爀愀 瀀漀搀攀爀 最甀愀爀搀愀爀 氀漀猀 瘀搀攀漀猀Ⰰ 渀攀挀攀猀椀琀愀猀 愀挀琀甀愀氀椀稀愀爀 儀甀椀挀欀吀椀洀攀 愀 氀愀 切氀琀椀洀愀 瘀攀爀猀椀渀⸀ 匀椀 愀挀愀戀愀猀 搀攀 椀渀猀琀愀氀愀爀 儀甀椀挀欀吀椀洀攀 礀 攀猀琀猀 瘀椀攀渀搀漀 攀猀琀攀 洀攀渀猀愀樀攀Ⰰ 爀攀椀渀椀挀椀愀 攀氀 漀爀搀攀渀愀搀漀爀 攀 椀渀琀渀琀愀氀漀 搀攀 渀甀攀瘀漀⸀∀ഀഀ
"[english]Replay_NeedQuicktimeNewer"	"In order to save movies, you need to upgrade to the latest version of QuickTime.  If you've just installed QuickTime and are seeing this message, reboot and try again."਍∀刀攀瀀氀愀礀开一攀攀搀儀甀椀挀欀琀椀洀攀∀ऀ∀倀愀爀愀 最甀愀爀搀愀爀 氀漀猀 瘀搀攀漀猀Ⰰ 瀀爀椀洀攀爀漀 琀椀攀渀攀猀 焀甀攀 椀渀猀琀愀氀愀爀 儀甀椀挀欀吀椀洀攀⸀ 匀椀 愀挀愀戀愀猀 搀攀 椀渀猀琀愀氀愀爀 儀甀椀挀欀吀椀洀攀 礀 攀猀琀猀 瘀椀攀渀搀漀 攀猀琀攀 洀攀渀猀愀樀攀Ⰰ 爀攀椀渀椀挀椀愀 攀氀 漀爀搀攀渀愀搀漀爀 攀 椀渀琀渀琀愀氀漀 搀攀 渀甀攀瘀漀⸀∀ഀഀ
"[english]Replay_NeedQuicktime"	"In order to save movies, you must first install QuickTime.  If you've just installed QuickTime and are seeing this message, reboot and try again."਍∀刀攀瀀氀愀礀开儀甀椀挀欀琀椀洀攀吀椀琀氀攀∀ऀ∀儀甀椀挀欀吀椀洀攀∀ഀഀ
"[english]Replay_QuicktimeTitle"	"QuickTime"਍∀刀攀瀀氀愀礀开䔀爀爀开儀吀开䘀愀椀氀攀搀吀漀䰀漀愀搀∀ऀ∀䔀爀爀漀爀 愀氀 挀愀爀最愀爀 儀甀椀挀欀吀椀洀攀⸀ 匀椀 愀挀愀戀愀猀 搀攀 椀渀猀琀愀氀愀爀 儀甀椀挀欀吀椀洀攀 礀 攀猀琀猀 瘀椀攀渀搀漀 攀猀琀攀 洀攀渀猀愀樀攀Ⰰ 爀攀椀渀椀挀椀愀 攀氀 漀爀搀攀渀愀搀漀爀 攀 椀渀琀渀琀愀氀漀 搀攀 渀甀攀瘀漀⸀∀ഀഀ
"[english]Replay_Err_QT_FailedToLoad"	"QuickTime failed to load.  If you've just installed QuickTime and are seeing this message, reboot and try again."਍∀刀攀瀀氀愀礀开伀瘀攀爀眀爀椀琀攀䐀氀最吀椀琀氀攀∀ऀ∀뼀匀漀戀爀攀猀挀爀椀戀椀爀 攀氀 愀爀挀栀椀瘀漀 攀砀椀猀琀攀渀琀攀㼀∀ഀഀ
"[english]Replay_OverwriteDlgTitle"	"Overwrite existing?"਍∀刀攀瀀氀愀礀开伀瘀攀爀眀爀椀琀攀䐀氀最吀攀砀琀∀ऀ∀夀愀 攀砀椀猀琀攀 甀渀愀 琀漀洀愀 挀漀渀 攀猀攀 渀漀洀戀爀攀⸀ 뼀儀甀椀攀爀攀猀 猀漀戀爀攀猀挀爀椀戀椀爀氀愀㼀∀ഀഀ
"[english]Replay_OverwriteDlgText"	"A take already exists with the given name.  Would you like to overwrite it?"਍∀刀攀瀀氀愀礀开䌀漀渀昀椀爀洀伀瘀攀爀眀爀椀琀攀∀ऀ∀匀Ⰰ 猀漀戀爀攀猀挀爀椀戀椀爀∀ഀഀ
"[english]Replay_ConfirmOverwrite"	"Yes, Overwrite"਍∀刀攀瀀氀愀礀开一漀琀䄀氀氀嘀椀搀攀漀䴀漀搀攀猀䄀瘀愀椀氀愀戀氀攀∀ऀ∀⨀ 一漀 琀漀搀漀猀 氀漀猀 洀漀搀漀猀 搀攀 瘀椀搀攀漀 攀猀琀渀 搀椀猀瀀漀渀椀戀氀攀猀 挀漀渀 琀甀 爀攀猀漀氀甀挀椀渀 愀挀琀甀愀氀⸀ 倀甀攀搀攀猀 猀漀氀甀挀椀漀渀愀爀氀漀 挀漀渀昀椀最甀爀愀渀搀漀 甀渀愀 爀攀猀漀氀甀挀椀渀 猀甀瀀攀爀椀漀爀 攀渀 伀倀䌀䤀伀一䔀匀 ⴀ㸀 嘀촀䐀䔀伀⸀∀ഀഀ
"[english]Replay_NotAllVideoModesAvailable"	"* Not all video modes are available at your current resolution.  You can fix this by moving to a higher screen resolution in OPTIONS -> VIDEO."਍∀刀攀瀀氀愀礀开刀攀猀开㐀㠀　瀀∀ऀ∀㐀㠀　瀀 ⠀㜀㈀　 砀 㐀㠀　 砀 ㈀㌀⸀㤀㜀㘀⤀∀ഀഀ
"[english]Replay_Res_480p"	"480p (720 x 480 x 23.976)"਍∀刀攀瀀氀愀礀开刀攀猀开㜀㈀　瀀∀ऀ∀㜀㈀　瀀 ⠀㄀㈀㠀　 砀 㜀㈀　 砀 ㈀㌀⸀㤀㘀㜀⤀∀ഀഀ
"[english]Replay_Res_720p"	"720p (1280 x 720 x 23.967)"਍∀刀攀瀀氀愀礀开刀攀猀开㄀　㠀　瀀∀ऀ∀㄀　㠀　瀀 ⠀㄀㤀㈀　 砀 ㄀　㠀　 砀 ㈀㌀⸀㤀㜀㘀⤀∀ഀഀ
"[english]Replay_Res_1080p"	"1080p (1920 x 1080 x 23.976)"਍∀刀攀瀀氀愀礀开刀攀猀开圀攀戀∀ऀ∀圀攀戀 ⠀㌀㈀　 砀 ㈀㐀　 砀 ㄀㔀⤀∀ഀഀ
"[english]Replay_Res_Web"	"Web (320 x 240 x 15)"਍∀刀攀瀀氀愀礀开刀攀猀开椀倀栀漀渀攀开䠀漀爀椀稀漀渀琀愀氀∀ऀ∀椀倀栀漀渀攀 䠀漀爀椀稀漀渀琀愀氀 ⠀㤀㘀　 砀 㘀㐀　 砀 ㈀㌀⸀㤀㜀㘀⤀∀ഀഀ
"[english]Replay_Res_iPhone_Horizontal"	"iPhone Horizontal (960 x 640 x 23.976)"਍∀刀攀瀀氀愀礀开刀攀猀开椀倀栀漀渀攀开嘀攀爀琀椀挀愀氀∀ऀ∀椀倀栀漀渀攀 嘀攀爀琀椀挀愀氀 ⠀㘀㐀　 砀 㤀㘀　 砀 ㈀㌀⸀㤀㜀㘀⤀∀ഀഀ
"[english]Replay_Res_iPhone_Vertical"	"iPhone Vertical (640 x 960 x 23.976)"਍∀䴀漀渀琀栀开㄀∀ऀ∀䔀渀攀爀漀∀ഀഀ
"[english]Month_1"	"January"਍∀䴀漀渀琀栀开㈀∀ऀ∀䘀攀戀爀攀爀漀∀ഀഀ
"[english]Month_2"	"February"਍∀䴀漀渀琀栀开㌀∀ऀ∀䴀愀爀稀漀∀ഀഀ
"[english]Month_3"	"March"਍∀䴀漀渀琀栀开㐀∀ऀ∀䄀戀爀椀氀∀ഀഀ
"[english]Month_4"	"April"਍∀䴀漀渀琀栀开㔀∀ऀ∀䴀愀礀漀∀ഀഀ
"[english]Month_5"	"May"਍∀䴀漀渀琀栀开㘀∀ऀ∀䨀甀渀椀漀∀ഀഀ
"[english]Month_6"	"June"਍∀䴀漀渀琀栀开㜀∀ऀ∀䨀甀氀椀漀∀ഀഀ
"[english]Month_7"	"July"਍∀䴀漀渀琀栀开㠀∀ऀ∀䄀最漀猀琀漀∀ഀഀ
"[english]Month_8"	"August"਍∀䴀漀渀琀栀开㤀∀ऀ∀匀攀瀀琀椀攀洀戀爀攀∀ഀഀ
"[english]Month_9"	"September"਍∀䴀漀渀琀栀开㄀　∀ऀ∀伀挀琀甀戀爀攀∀ഀഀ
"[english]Month_10"	"October"਍∀䴀漀渀琀栀开㄀㄀∀ऀ∀一漀瘀椀攀洀戀爀攀∀ഀഀ
"[english]Month_11"	"November"਍∀䴀漀渀琀栀开㄀㈀∀ऀ∀䐀椀挀椀攀洀戀爀攀∀ഀഀ
"[english]Month_12"	"December"਍∀刀攀瀀氀愀礀开䴀漀瘀椀攀刀攀渀搀攀爀䤀渀昀漀∀ऀ∀刀攀猀漀氀甀挀椀渀㨀 ─爀攀猀─尀渀䤀洀最⸀ 瀀漀爀 猀攀最甀渀搀漀㨀 ─昀爀愀洀攀爀愀琀攀─尀渀䌀愀氀椀搀愀搀 搀攀氀 搀攀猀攀渀昀漀焀甀攀 搀攀 洀漀瘀⸀㨀 ─洀漀琀椀漀渀戀氀甀爀焀甀愀氀椀琀礀─尀渀䌀搀攀挀㨀 ─挀漀搀攀挀─尀渀䌀愀氀椀搀愀搀 搀攀 氀愀 挀漀搀椀昀椀挀愀挀椀渀㨀 ─攀渀挀漀搀椀渀最焀甀愀氀椀琀礀─尀渀匀甀愀瘀椀稀愀搀漀㨀 ─愀渀琀椀愀氀椀愀猀椀渀最─尀渀吀椀攀洀瀀漀 搀攀 爀攀渀搀攀爀椀稀愀搀漀㨀 ─爀攀渀搀攀爀琀椀洀攀─尀渀吀䜀䄀⼀圀䄀嘀㨀 ─爀愀眀─∀ഀഀ
"[english]Replay_MovieRenderInfo"	"Resolution:   %res%\nFramerate:   %framerate%\nMotion blur quality:   %motionblurquality%\nCodec:   %codec%\nEncoding quality:   %encodingquality%\nAntialiasing:   %antialiasing%\nRender time:   %rendertime%\nRaw TGA's/WAV:   %raw%"਍∀刀攀瀀氀愀礀开䔀渀愀戀氀攀搀∀ऀ∀䄀挀琀椀瘀愀搀漀∀ഀഀ
"[english]Replay_Enabled"	"Enabled"਍∀刀攀瀀氀愀礀开䐀椀猀愀戀氀攀搀∀ऀ∀一漀 搀椀猀瀀漀渀椀戀氀攀∀ഀഀ
"[english]Replay_Disabled"	"Disabled"਍∀刀攀瀀氀愀礀开刀攀渀搀攀爀䤀渀昀漀∀ऀ∀䤀一䘀伀⸀ 䐀䔀 刀䔀一䐀䔀刀䤀娀䄀䐀伀∀ഀഀ
"[english]Replay_RenderInfo"	"RENDER INFO"਍∀刀攀瀀氀愀礀开刀攀眀椀渀搀圀愀爀渀椀渀最吀椀琀氀攀∀ऀ∀刀䔀䈀伀䈀䤀一䄀刀∀ഀഀ
"[english]Replay_RewindWarningTitle"	"REWIND"਍∀刀攀瀀氀愀礀开刀攀眀椀渀搀圀愀爀渀椀渀最䴀猀最∀ऀ∀刀攀戀漀戀椀渀愀爀 攀氀 瘀椀搀攀漀 瀀甀攀搀攀 氀氀攀瘀愀爀 甀渀 洀漀洀攀渀琀漀 漀 搀漀猀⸀ 䄀 瀀攀猀愀爀 搀攀 焀甀攀 氀愀 椀洀愀最攀渀 瀀甀攀搀愀 椀爀 愀 猀愀氀琀漀猀Ⰰ 渀漀 瀀攀爀搀攀爀猀 渀椀渀最切渀 挀愀洀戀椀漀 焀甀攀 栀愀礀愀猀 爀攀愀氀椀稀愀搀漀⸀ 䔀猀琀攀 洀攀渀猀愀樀攀 渀漀 瘀漀氀瘀攀爀 愀 愀瀀愀爀攀挀攀爀⸀∀ഀഀ
"[english]Replay_RewindWarningMsg"	"Rewinding may take a moment or two.  Although you may experience dizziness, you will not lose any changes you've made.  This message will not appear again."਍∀刀攀瀀氀愀礀开夀漀甀吀甀戀攀唀刀䰀∀ऀ∀唀刀䰀 䐀䔀 夀伀唀吀唀䈀䔀∀ഀഀ
"[english]Replay_YouTubeURL"	"YOUTUBE URL"਍∀刀攀瀀氀愀礀开䌀愀琀攀最漀爀礀∀ऀ∀䌀䄀吀䔀䜀伀刀촀䄀匀∀ഀഀ
"[english]Replay_Category"	"CATEGORIES"਍∀刀攀瀀氀愀礀开䌀氀攀愀渀椀渀最䐀椀猀欀∀ऀ∀刀攀愀氀椀稀愀渀搀漀 甀渀愀 氀椀洀瀀椀攀稀愀 搀攀 搀愀琀漀猀 椀渀渀攀挀攀猀愀爀椀漀猀⸀ 䔀猀琀漀 瀀甀攀搀攀 氀氀攀瘀愀爀 甀渀 琀椀攀洀瀀漀⸀⸀⸀∀ഀഀ
"[english]Replay_CleaningDisk"	"Doing one-time cleanup of unneeded data.  This may take a minute..."਍∀刀攀瀀氀愀礀开䘀椀爀猀琀刀攀渀搀攀爀儀甀攀甀攀䄀搀搀吀椀琀氀攀∀ऀ∀䌀漀氀愀 搀攀 刀攀渀搀攀爀椀稀愀搀漀∀ഀഀ
"[english]Replay_FirstRenderQueueAddTitle"	"Render Queue"਍∀刀攀瀀氀愀礀开䘀椀爀猀琀刀攀渀搀攀爀儀甀攀甀攀䄀搀搀䴀猀最∀ऀ∀䠀愀猀 愀愀搀椀搀漀 甀渀愀 琀漀洀愀 愀 琀甀 挀漀氀愀 搀攀 爀攀渀搀攀爀椀稀愀搀漀⸀尀渀尀渀倀甀攀搀攀猀 愀愀搀椀爀 洀切氀琀椀瀀氀攀猀 琀漀洀愀猀 礀 最甀愀爀搀愀爀氀愀猀 琀漀搀愀猀 愀 氀愀 瘀攀稀 瀀甀氀猀愀渀搀漀 尀∀䜀唀䄀刀䐀䄀刀 吀伀䐀䄀匀尀∀ 攀渀 攀氀 洀攀渀切 搀攀 爀攀瀀爀漀搀甀挀挀椀渀⸀∀ഀഀ
"[english]Replay_FirstRenderQueueAddMsg"	"You have added a take to your render queue.\n\nYou can add multiple takes and save them all at once by clicking \"SAVE ALL\" in the replay browser."਍∀刀攀瀀氀愀礀开唀猀攀嘀䰀䌀倀氀愀礀攀爀∀ऀ∀匀攀 爀攀挀漀洀椀攀渀搀愀 甀琀椀氀椀稀愀爀 嘀䰀䌀 瀀愀爀愀 瘀攀爀 氀漀猀 瘀椀搀攀漀猀 最甀愀爀搀愀搀漀猀⸀∀ഀഀ
"[english]Replay_UseVLCPlayer"	"It is recommended that you use VLC to view saved movies."਍紀ഀഀ
}਍
