"lang"਍笀ഀഀ
"Language"	"latam"਍∀吀漀欀攀渀猀∀ഀഀ
{਍∀嘀愀氀瘀攀开䰀椀猀琀攀渀开䴀愀瀀一愀洀攀∀ऀ∀䴀愀瀀愀∀ഀഀ
"[english]Valve_Listen_MapName"	"Map"਍∀嘀愀氀瘀攀开䴀漀瘀攀洀攀渀琀开吀椀琀氀攀∀ऀ∀䴀伀嘀䤀䴀䤀䔀一吀伀∀ഀഀ
"[english]Valve_Movement_Title"	"MOVEMENT"਍∀嘀愀氀瘀攀开䴀漀瘀攀开䘀漀爀眀愀爀搀∀ऀ∀䄀瘀愀渀稀愀爀∀ഀഀ
"[english]Valve_Move_Forward"	"Move forward"਍∀嘀愀氀瘀攀开䴀漀瘀攀开䈀愀挀欀∀ऀ∀刀攀琀爀漀挀攀搀攀爀∀ഀഀ
"[english]Valve_Move_Back"	"Move back"਍∀嘀愀氀瘀攀开吀甀爀渀开䰀攀昀琀∀ऀ∀䜀椀爀愀爀 愀 氀愀 椀稀焀甀椀攀爀搀愀∀ഀഀ
"[english]Valve_Turn_Left"	"Turn left"਍∀嘀愀氀瘀攀开吀甀爀渀开刀椀最栀琀∀ऀ∀䜀椀爀愀爀 愀 氀愀 搀攀爀攀挀栀愀∀ഀഀ
"[english]Valve_Turn_Right"	"Turn right"਍∀嘀愀氀瘀攀开䴀漀瘀攀开䰀攀昀琀∀ऀ∀䐀攀猀瀀氀愀稀愀洀椀攀渀琀漀 氀愀琀攀爀愀氀 椀稀焀⸀∀ഀഀ
"[english]Valve_Move_Left"	"Move left (strafe)"਍∀嘀愀氀瘀攀开䴀漀瘀攀开刀椀最栀琀∀ऀ∀䐀攀猀瀀氀愀稀愀洀椀攀渀琀漀 氀愀琀攀爀愀氀 搀挀栀愀⸀∀ഀഀ
"[english]Valve_Move_Right"	"Move right (strafe)"਍∀嘀愀氀瘀攀开䨀甀洀瀀∀ऀ∀匀愀氀琀愀爀∀ഀഀ
"[english]Valve_Jump"	"Jump"਍∀嘀愀氀瘀攀开䐀甀挀欀∀ऀ∀䄀最愀挀栀愀爀猀攀∀ഀഀ
"[english]Valve_Duck"	"Duck"਍∀嘀愀氀瘀攀开匀眀椀洀开唀瀀∀ऀ∀一愀搀愀爀 栀愀挀椀愀 愀爀爀椀戀愀∀ഀഀ
"[english]Valve_Swim_Up"	"Swim up"਍∀嘀愀氀瘀攀开匀眀椀洀开䐀漀眀渀∀ऀ∀一愀搀愀爀 栀愀挀椀愀 愀戀愀樀漀∀ഀഀ
"[english]Valve_Swim_Down"	"Swim down"਍∀嘀愀氀瘀攀开䰀漀漀欀开唀瀀∀ऀ∀䴀椀爀愀爀 愀爀爀椀戀愀∀ഀഀ
"[english]Valve_Look_Up"	"Look up"਍∀嘀愀氀瘀攀开䰀漀漀欀开䐀漀眀渀∀ऀ∀䴀椀爀愀爀 愀戀愀樀漀∀ഀഀ
"[english]Valve_Look_Down"	"Look down"਍∀嘀愀氀瘀攀开䰀漀漀欀开匀琀爀愀椀最栀琀开䄀栀攀愀搀∀ऀ∀䴀椀爀愀爀 愀氀 昀爀攀渀琀攀∀ഀഀ
"[english]Valve_Look_Straight_Ahead"	"Look straight ahead"਍∀嘀愀氀瘀攀开匀琀爀愀昀攀开䴀漀搀椀昀椀攀爀∀ऀ∀䴀漀搀椀昀椀挀愀搀漀爀 洀漀瘀⸀ 氀愀琀攀爀愀氀∀ഀഀ
"[english]Valve_Strafe_Modifier"	"Strafe modifier"਍∀嘀愀氀瘀攀开䴀漀甀猀攀开䰀漀漀欀开䴀漀搀椀昀椀攀爀∀ऀ∀䴀漀搀椀昀椀挀愀搀漀爀 瘀椀猀琀愀 爀愀琀渀∀ഀഀ
"[english]Valve_Mouse_Look_Modifier"	"Mouse look modifier"਍∀嘀愀氀瘀攀开䬀攀礀戀漀愀爀搀开䰀漀漀欀开䴀漀搀椀昀椀攀爀∀ऀ∀䴀漀搀⸀ 瘀椀猀琀愀 挀漀渀 琀攀挀氀愀搀漀∀ഀഀ
"[english]Valve_Keyboard_Look_Modifier"	"Keyboard look modifier"਍∀嘀愀氀瘀攀开唀猀攀开䤀琀攀洀猀∀ऀ∀唀猀愀爀 漀戀樀攀琀漀 ⠀戀漀琀漀渀攀猀Ⰰ 洀焀甀椀渀愀猀Ⰰ⸀⸀⸀⤀∀ഀഀ
"[english]Valve_Use_Items"	"Use item (buttons, machines, ...)"਍∀嘀愀氀瘀攀开倀椀挀欀甀瀀开唀猀攀开伀戀樀攀挀琀猀∀ऀ∀刀攀挀漀最攀爀⼀甀猀愀爀 漀戀樀攀琀漀猀∀ഀഀ
"[english]Valve_Pickup_Use_Objects"	"Pickup/Use objects"਍∀嘀愀氀瘀攀开䌀漀洀洀甀渀椀挀愀琀椀漀渀开吀椀琀氀攀∀ऀ∀䌀伀䴀唀一䤀䌀䄀䌀䤀팀一∀ഀഀ
"[english]Valve_Communication_Title"	"COMMUNICATION"਍∀嘀愀氀瘀攀开唀猀攀开嘀漀椀挀攀开䌀漀洀洀甀渀椀挀愀琀椀漀渀∀ऀ∀唀猀愀爀 挀漀洀甀渀椀挀愀挀椀渀 瀀漀爀 瘀漀稀∀ഀഀ
"[english]Valve_Use_Voice_Communication"	"Use voice communication"਍∀嘀愀氀瘀攀开䌀栀愀琀开䴀攀猀猀愀最攀∀ऀ∀䴀攀渀猀愀樀攀 搀攀 挀栀愀琀∀ഀഀ
"[english]Valve_Chat_Message"	"Chat message"਍∀嘀愀氀瘀攀开吀攀愀洀开䴀攀猀猀愀最攀∀ऀ∀䴀攀渀猀愀樀攀 搀攀 攀焀甀椀瀀漀∀ഀഀ
"[english]Valve_Team_Message"	"Team message"਍∀嘀愀氀瘀攀开䌀漀洀戀愀琀开吀椀琀氀攀∀ऀ∀䄀吀䄀儀唀䔀∀ഀഀ
"[english]Valve_Combat_Title"	"COMBAT"਍∀嘀愀氀瘀攀开倀爀椀洀愀爀礀开䄀琀琀愀挀欀∀ऀ∀䄀琀愀焀甀攀 瀀爀椀渀挀椀瀀愀氀∀ഀഀ
"[english]Valve_Primary_Attack"	"Primary attack"਍∀嘀愀氀瘀攀开匀攀挀漀渀搀愀爀礀开䄀琀琀愀挀欀∀ऀ∀䄀琀愀焀甀攀 猀攀挀甀渀搀愀爀椀漀∀ഀഀ
"[english]Valve_Secondary_Attack"	"Secondary attack"਍∀嘀愀氀瘀攀开刀攀氀漀愀搀开圀攀愀瀀漀渀∀ऀ∀刀攀挀愀爀最愀爀 愀爀洀愀∀ഀഀ
"[english]Valve_Reload_Weapon"	"Reload weapon"਍∀嘀愀氀瘀攀开圀愀氀欀∀ऀ∀䌀愀洀椀渀愀爀 ⠀洀漀瘀攀爀猀攀 氀攀渀琀愀洀攀渀琀攀⤀∀ഀഀ
"[english]Valve_Walk"	"Walk (Move Slowly)"਍∀嘀愀氀瘀攀开䘀氀愀猀栀氀椀最栀琀∀ऀ∀䰀椀渀琀攀爀渀愀∀ഀഀ
"[english]Valve_Flashlight"	"Flashlight"਍∀嘀愀氀瘀攀开匀瀀爀愀礀开䰀漀最漀∀ऀ∀䰀漀最漀琀椀瀀漀 搀攀 愀攀爀漀猀漀氀∀ഀഀ
"[english]Valve_Spray_Logo"	"Spray logo"਍∀嘀愀氀瘀攀开匀攀爀瘀攀爀伀昀昀攀爀椀渀最吀漀䌀漀渀渀攀挀琀∀ऀ∀䔀猀琀攀 猀攀爀瘀椀搀漀爀 琀攀 攀猀琀 漀昀爀攀挀椀攀渀搀漀 挀漀渀攀挀琀愀爀琀攀 愀㨀∀ഀഀ
"[english]Valve_ServerOfferingToConnect"	"The server is offering to connect you to:"਍∀嘀愀氀瘀攀开倀爀攀猀猀䬀攀礀吀漀䄀挀挀攀瀀琀∀ऀ∀倀甀氀猀愀 ─猀㄀ 瀀愀爀愀 愀挀攀瀀琀愀爀⸀∀ഀഀ
"[english]Valve_PressKeyToAccept"	"Press %s1 to accept."਍∀嘀愀氀瘀攀开䈀椀渀搀䬀攀礀吀漀䄀挀挀攀瀀琀∀ऀ∀䌀漀渀昀椀最甀爀愀 甀渀愀 琀攀挀氀愀 瀀愀爀愀 愀挀攀瀀琀愀爀⸀∀ഀഀ
"[english]Valve_BindKeyToAccept"	"Please configure a key to accept."਍∀嘀愀氀瘀攀开圀攀愀瀀漀渀开䌀愀琀攀最漀爀礀开㄀∀ऀ∀䌀愀琀攀最漀爀愀 搀攀 愀爀洀愀猀 ㄀∀ഀഀ
"[english]Valve_Weapon_Category_1"	"Weapon category 1"਍∀嘀愀氀瘀攀开圀攀愀瀀漀渀开䌀愀琀攀最漀爀礀开㈀∀ऀ∀䌀愀琀攀最漀爀愀 搀攀 愀爀洀愀猀 ㈀∀ഀഀ
"[english]Valve_Weapon_Category_2"	"Weapon category 2"਍∀嘀愀氀瘀攀开圀攀愀瀀漀渀开䌀愀琀攀最漀爀礀开㌀∀ऀ∀䌀愀琀攀最漀爀愀 搀攀 愀爀洀愀猀 ㌀∀ഀഀ
"[english]Valve_Weapon_Category_3"	"Weapon category 3"਍∀嘀愀氀瘀攀开圀攀愀瀀漀渀开䌀愀琀攀最漀爀礀开㐀∀ऀ∀䌀愀琀攀最漀爀愀 搀攀 愀爀洀愀猀 㐀∀ഀഀ
"[english]Valve_Weapon_Category_4"	"Weapon category 4"਍∀嘀愀氀瘀攀开圀攀愀瀀漀渀开䌀愀琀攀最漀爀礀开㔀∀ऀ∀䌀愀琀攀最漀爀愀 搀攀 愀爀洀愀猀 㔀∀ഀഀ
"[english]Valve_Weapon_Category_5"	"Weapon category 5"਍∀嘀愀氀瘀攀开圀攀愀瀀漀渀开䌀愀琀攀最漀爀礀开㘀∀ऀ∀䌀愀琀攀最漀爀愀 搀攀 愀爀洀愀猀 㘀∀ഀഀ
"[english]Valve_Weapon_Category_6"	"Weapon category 6"਍∀嘀愀氀瘀攀开圀攀愀瀀漀渀开䌀愀琀攀最漀爀礀开㜀∀ऀ∀䌀愀琀攀最漀爀愀 搀攀 愀爀洀愀猀 㜀∀ഀഀ
"[english]Valve_Weapon_Category_7"	"Weapon category 7"਍∀嘀愀氀瘀攀开圀攀愀瀀漀渀开䌀愀琀攀最漀爀礀开㠀∀ऀ∀䌀愀琀攀最漀爀愀 搀攀 愀爀洀愀猀 㠀∀ഀഀ
"[english]Valve_Weapon_Category_8"	"Weapon category 8"਍∀嘀愀氀瘀攀开圀攀愀瀀漀渀开䌀愀琀攀最漀爀礀开㤀∀ऀ∀䌀愀琀攀最漀爀愀 搀攀 愀爀洀愀猀 㤀∀ഀഀ
"[english]Valve_Weapon_Category_9"	"Weapon category 9"਍∀嘀愀氀瘀攀开圀攀愀瀀漀渀开䌀愀琀攀最漀爀礀开　∀ऀ∀䌀愀琀攀最漀爀愀 搀攀 愀爀洀愀猀 　∀ഀഀ
"[english]Valve_Weapon_Category_0"	"Weapon category 0"਍∀嘀愀氀瘀攀开倀爀攀瘀椀漀甀猀开圀攀愀瀀漀渀∀ऀ∀䄀爀洀愀 愀渀琀攀爀椀漀爀∀ഀഀ
"[english]Valve_Previous_Weapon"	"Previous weapon"਍∀嘀愀氀瘀攀开一攀砀琀开圀攀愀瀀漀渀∀ऀ∀䄀爀洀愀 猀椀最甀椀攀渀琀攀∀ഀഀ
"[english]Valve_Next_Weapon"	"Next weapon"਍∀嘀愀氀瘀攀开䰀愀猀琀开圀攀愀瀀漀渀开唀猀攀搀∀ऀ∀氀琀椀洀愀 愀爀洀愀 甀猀愀搀愀∀ഀഀ
"[english]Valve_Last_Weapon_Used"	"Last weapon used"਍∀嘀愀氀瘀攀开䴀椀猀挀攀氀氀愀渀攀漀甀猀开吀椀琀氀攀∀ऀ∀嘀䄀刀䤀伀匀∀ഀഀ
"[english]Valve_Miscellaneous_Title"	"MISCELLANEOUS"਍∀嘀愀氀瘀攀开䐀椀猀瀀氀愀礀开匀挀漀爀攀猀∀ऀ∀䴀漀猀琀爀愀爀 瀀甀渀琀甀愀挀椀漀渀攀猀 洀甀氀琀椀樀甀最愀搀漀爀∀ഀഀ
"[english]Valve_Display_Scores"	"Display multiplayer scores"਍∀嘀愀氀瘀攀开吀愀欀攀开匀挀爀攀攀渀开匀栀漀琀∀ऀ∀䌀愀瀀琀甀爀愀 搀攀 瀀愀渀琀愀氀氀愀∀ഀഀ
"[english]Valve_Take_Screen_Shot"	"Take screen shot"਍∀嘀愀氀瘀攀开儀甀椀挀欀开匀愀瘀攀∀ऀ∀䜀甀愀爀搀愀搀漀 爀瀀椀搀漀∀ഀഀ
"[english]Valve_Quick_Save"	"Quick save"਍∀嘀愀氀瘀攀开儀甀椀挀欀开䰀漀愀搀∀ऀ∀䌀愀爀最愀 爀瀀椀搀愀∀ഀഀ
"[english]Valve_Quick_Load"	"Quick load"਍∀嘀愀氀瘀攀开倀愀甀猀攀开䜀愀洀攀∀ऀ∀倀愀甀猀愀爀 樀甀攀最漀∀ഀഀ
"[english]Valve_Pause_Game"	"Pause game"਍∀嘀愀氀瘀攀开儀甀椀琀开䜀愀洀攀∀ऀ∀䄀戀愀渀搀漀渀愀爀∀ഀഀ
"[english]Valve_Quit_Game"	"Quit game"਍∀嘀愀氀瘀攀开䄀挀挀攀瀀琀开刀攀搀椀爀攀挀琀∀ऀ∀倀攀爀洀椀琀椀爀 爀攀搀椀爀攀挀挀椀漀渀愀洀椀攀渀琀漀 愀 漀琀爀漀 猀攀爀瘀椀搀漀爀∀ഀഀ
"[english]Valve_Accept_Redirect"	"Accept redirect to another server"਍∀嘀愀氀瘀攀开䌀栀攀攀爀∀ऀ∀伀瘀愀挀椀渀∀ഀഀ
"[english]Valve_Cheer"	"Cheer"਍∀嘀愀氀瘀攀开䄀挀琀椀瘀愀琀攀开䤀渀开䜀愀洀攀开䜀唀䤀∀ऀ∀䄀挀琀椀瘀愀爀 椀渀琀攀爀昀愀稀 搀攀 甀猀甀愀爀椀漀∀ഀഀ
"[english]Valve_Activate_In_Game_GUI"	"Activate in-game GUI"਍∀嘀愀氀瘀攀开䌀栀愀渀最攀开吀攀愀洀∀ऀ∀䌀愀洀戀椀愀爀 攀焀甀椀瀀漀∀ഀഀ
"[english]Valve_Change_Team"	"Change team"਍∀嘀愀氀瘀攀开䌀栀愀渀最攀开䌀氀愀猀猀∀ऀ∀䌀愀洀戀椀愀爀 挀氀愀猀攀∀ഀഀ
"[english]Valve_Change_Class"	"Change class"਍∀嘀愀氀瘀攀开唀猀攀开匀瀀攀挀椀愀氀开匀欀椀氀氀∀ऀ∀唀猀愀爀 栀愀戀椀氀椀搀愀搀 攀猀瀀攀挀椀愀氀∀ഀഀ
"[english]Valve_Use_Special_Skill"	"Use special skill"਍∀嘀愀氀瘀攀开䴀甀氀琀椀瀀氀愀礀攀爀开䐀攀挀愀氀开䰀椀洀椀琀∀ऀ∀䰀洀椀琀攀 搀攀 挀愀氀挀漀猀 洀甀氀琀椀樀甀最愀搀漀爀∀ഀഀ
"[english]Valve_Multiplayer_Decal_Limit"	"Multiplayer decal limit"਍∀嘀愀氀瘀攀开嘀愀氀椀搀开吀攀愀洀猀∀ऀ∀䔀焀甀椀瀀漀猀 瘀氀椀搀漀猀Ⰰ 攀渀 戀氀愀渀挀漀 瀀愀爀愀 琀漀搀漀猀∀ഀഀ
"[english]Valve_Valid_Teams"	"Valid teams, leave blank for all"਍∀嘀愀氀瘀攀开䘀爀愀最开䰀椀洀椀琀∀ऀ∀䰀洀椀琀攀 搀攀 洀甀攀爀琀攀猀∀ഀഀ
"[english]Valve_Frag_Limit"	"Frag Limit"਍∀嘀愀氀瘀攀开吀椀洀攀开䰀椀洀椀琀∀ऀ∀䰀洀椀琀攀 搀攀 琀椀攀洀瀀漀 ⠀洀渀⸀⤀∀ഀഀ
"[english]Valve_Time_Limit"	"Time Limit (Min.)"਍∀嘀愀氀瘀攀开䘀愀氀氀椀渀最开䐀愀洀愀最攀∀ऀ∀䐀愀漀 攀渀 挀愀搀愀∀ഀഀ
"[english]Valve_Falling_Damage"	"Falling Damage"਍∀嘀愀氀瘀攀开一漀爀洀愀氀∀ऀ∀一漀爀洀愀氀∀ഀഀ
"[english]Valve_Normal"	"Normal"਍∀嘀愀氀瘀攀开刀攀愀氀椀猀琀椀挀∀ऀ∀刀攀愀氀椀猀琀愀∀ഀഀ
"[english]Valve_Realistic"	"Realistic"਍∀嘀愀氀瘀攀开吀攀愀洀瀀氀愀礀∀ऀ∀䨀甀攀最漀 攀渀 攀焀甀椀瀀漀∀ഀഀ
"[english]Valve_Teamplay"	"Teamplay"਍∀嘀愀氀瘀攀开䘀爀椀攀渀搀氀礀开䘀椀爀攀∀ऀ∀䘀甀攀最漀 愀氀椀愀搀漀∀ഀഀ
"[english]Valve_Friendly_Fire"	"Friendly Fire"਍∀嘀愀氀瘀攀开圀攀愀瀀漀渀猀开匀琀愀礀∀ऀ∀䰀愀猀 愀爀洀愀猀 瀀攀爀洀愀渀攀挀攀渀∀ഀഀ
"[english]Valve_Weapons_Stay"	"Weapons Stay"਍∀嘀愀氀瘀攀开䘀漀爀挀攀开刀攀猀瀀愀眀渀∀ऀ∀䘀漀爀稀愀爀 爀攀最攀渀攀爀愀挀椀渀∀ഀഀ
"[english]Valve_Force_Respawn"	"Force Respawn"਍∀嘀愀氀瘀攀开䘀漀漀琀猀琀攀瀀猀∀ऀ∀倀愀猀漀猀∀ഀഀ
"[english]Valve_Footsteps"	"Footsteps"਍∀嘀愀氀瘀攀开䄀甀琀漀挀爀漀猀猀栀愀椀爀∀ऀ∀䴀椀爀愀 愀甀琀漀洀琀椀挀愀∀ഀഀ
"[english]Valve_Autocrosshair"	"Autocrosshair"਍∀嘀愀氀瘀攀开䌀攀渀琀攀爀开倀氀愀礀攀爀开一愀洀攀猀∀ऀ∀䌀攀渀琀爀愀爀 渀漀洀戀爀攀猀 搀攀 樀甀最愀搀漀爀攀猀∀ഀഀ
"[english]Valve_Center_Player_Names"	"Center player names"਍∀嘀愀氀瘀攀开匀眀椀琀挀栀开圀攀愀瀀漀渀猀开䤀洀洀攀搀椀愀琀攀氀礀∀ऀ∀䌀愀洀戀椀愀爀 愀爀洀愀猀 搀攀 椀渀洀攀搀椀愀琀漀∀ഀഀ
"[english]Valve_Switch_Weapons_Immediately"	"Switch weapons immediately"਍∀嘀愀氀瘀攀开䄀甀琀漀洀愀琀椀挀开匀挀爀攀攀渀猀栀漀琀猀∀ऀ∀䌀愀瀀琀甀爀愀猀 搀攀 瀀愀渀琀愀氀氀愀 愀甀琀漀洀琀椀挀愀猀 愀氀 愀挀愀戀愀爀∀ഀഀ
"[english]Valve_Automatic_Screenshots"	"Automatically take end-game screenshots"਍∀嘀愀氀瘀攀开伀戀猀攀爀瘀攀爀开䌀爀漀猀猀栀愀椀爀∀ऀ∀䴀椀爀愀 搀攀氀 漀戀猀攀爀瘀愀搀漀爀∀ഀഀ
"[english]Valve_Observer_Crosshair"	"Observer crosshair"਍∀嘀愀氀瘀攀开䌀漀渀猀漀氀攀开吀漀最最氀攀∀ऀ∀䄀挀琀椀瘀愀爀⼀搀攀猀愀挀琀椀瘀愀爀 挀漀渀猀漀氀愀 搀攀氀 瀀爀漀最爀愀洀愀搀漀爀∀ഀഀ
"[english]Valve_Console_Toggle"	"Toggle developer console"਍∀匀瀀攀挀开匀氀漀眀开䴀漀琀椀漀渀∀ऀ∀䌀洀愀爀愀 氀攀渀琀愀∀ഀഀ
"[english]Spec_Slow_Motion"	"Slow Motion"਍∀匀瀀攀挀开一漀开倀䤀倀∀ऀ∀倀椀挀琀甀爀攀ⴀ䤀渀ⴀ倀椀挀琀甀爀攀 渀漀 攀猀琀 搀椀猀瀀漀渀椀戀氀攀 攀渀 洀漀搀漀 倀爀椀洀攀爀愀 倀攀爀猀漀渀愀 搀甀爀愀渀琀攀 攀氀 樀甀攀最漀⸀∀ഀഀ
"[english]Spec_No_PIP"	"਍倀椀挀琀甀爀攀ⴀ䤀渀ⴀ瀀椀挀琀甀爀攀 椀猀 渀漀琀 愀瘀愀椀氀愀戀氀攀ഀഀ
in first-person mode while playing.਍∀ഀഀ
"Spec_Replay"	"Repetición instantánea"਍∀嬀攀渀最氀椀猀栀崀匀瀀攀挀开刀攀瀀氀愀礀∀ऀ∀䤀渀猀琀愀渀琀 刀攀瀀氀愀礀∀ഀഀ
"Spec_Auto"	"Automático"਍∀嬀攀渀最氀椀猀栀崀匀瀀攀挀开䄀甀琀漀∀ऀ∀䄀甀琀漀∀ഀഀ
"Spec_Time"	"Tiempo"਍∀嬀攀渀最氀椀猀栀崀匀瀀攀挀开吀椀洀攀∀ऀ∀吀椀洀攀∀ഀഀ
"Spec_Map"	"Mapa: %s1"਍∀嬀攀渀最氀椀猀栀崀匀瀀攀挀开䴀愀瀀∀ऀ∀䴀愀瀀㨀 ─猀㄀∀ഀഀ
"Spectators"	"Espectadores"਍∀嬀攀渀最氀椀猀栀崀匀瀀攀挀琀愀琀漀爀猀∀ऀ∀匀瀀攀挀琀愀琀漀爀猀∀ഀഀ
"Spec_PlayerItem_Health"	"%s1 (%s2)"਍∀嬀攀渀最氀椀猀栀崀匀瀀攀挀开倀氀愀礀攀爀䤀琀攀洀开䠀攀愀氀琀栀∀ऀ∀─猀㄀ ⠀─猀㈀⤀∀ഀഀ
"Spec_PlayerItem"	"%s1"਍∀嬀攀渀最氀椀猀栀崀匀瀀攀挀开倀氀愀礀攀爀䤀琀攀洀∀ऀ∀─猀㄀∀ഀഀ
"Spec_PlayerItem_Team"	"%s1 (%s2)"਍∀嬀攀渀最氀椀猀栀崀匀瀀攀挀开倀氀愀礀攀爀䤀琀攀洀开吀攀愀洀∀ऀ∀─猀㄀ ⠀─猀㈀⤀∀ഀഀ
"Spec_Duck"	"Pulsa AGACHARSE para ver el menú de espectador"਍∀嬀攀渀最氀椀猀栀崀匀瀀攀挀开䐀甀挀欀∀ऀ∀倀爀攀猀猀 䐀唀䌀䬀 昀漀爀 匀瀀攀挀琀愀琀漀爀 䴀攀渀甀∀ഀഀ
"Spec_Help_Title"	"Modo espectador"਍∀嬀攀渀最氀椀猀栀崀匀瀀攀挀开䠀攀氀瀀开吀椀琀氀攀∀ऀ∀匀瀀攀挀琀愀琀漀爀 䴀漀搀攀∀ഀഀ
"Spec_Help_Text"	"਍倀甀氀猀愀 氀愀猀 琀攀挀氀愀猀 猀椀最甀椀攀渀琀攀猀 瀀愀爀愀 挀愀洀戀椀愀爀 氀愀猀 瘀椀猀琀愀猀㨀ഀഀ
਍ 䐀䤀匀倀䄀刀䄀刀㄀㨀 倀攀爀猀攀最甀椀爀 愀氀 樀甀最愀搀漀爀 猀椀最甀椀攀渀琀攀ഀഀ
 DISPARAR2: Perseguir al jugador anterior਍ 匀䄀䰀吀䄀刀㨀 䌀愀洀戀椀愀爀 洀漀搀漀猀 搀攀 瘀椀猀琀愀ഀഀ
 USAR: Cambiar modo de ventana de recuadro਍ ഀഀ
 AGACHARSE: Activar menú espectador਍  ഀഀ
En el modo de vista de mapa, puedes desplazarte con:਍ഀഀ
 IZQUIERDA: hacia la izquierda਍ 䐀䔀刀䔀䌀䠀䄀㨀 栀愀挀椀愀 氀愀 搀攀爀攀挀栀愀ഀഀ
 ADELANTE: Acercarte਍ 䄀吀刀섀匀㨀 䄀氀攀樀愀爀琀攀ഀഀ
 RATÓN: girar alrededor de mapa/objetivo਍∀ഀഀ
"[english]Spec_Help_Text"	"਍唀猀攀 琀栀攀 昀漀氀氀漀眀椀渀最 欀攀礀猀 琀漀 挀栀愀渀最攀 瘀椀攀眀 猀琀礀氀攀猀㨀ഀഀ
਍ 䘀䤀刀䔀㄀ ⴀ 䌀栀愀猀攀 渀攀砀琀 瀀氀愀礀攀爀ഀഀ
 FIRE2 - Chase previous player਍ 䨀唀䴀倀 ⴀ 䌀栀愀渀最攀 瘀椀攀眀 洀漀搀攀猀ഀഀ
 USE - Change inset window mode਍ ഀഀ
 DUCK  - Enable spectator menu਍  ഀഀ
In Overview Map Mode move around with:਍ഀഀ
 MOVELEFT - move left਍ 䴀伀嘀䔀刀䤀䜀䠀吀 ⴀ 洀漀瘀攀 爀椀最栀琀ഀഀ
 FORWARD - zoom in਍ 䈀䄀䌀䬀 ⴀ 稀漀漀洀 漀甀琀ഀഀ
 MOUSE - rotate around map/target਍∀ഀഀ
"Spec_Modes"	"Opciones de cámara"਍∀嬀攀渀最氀椀猀栀崀匀瀀攀挀开䴀漀搀攀猀∀ऀ∀䌀愀洀攀爀愀 伀瀀琀椀漀渀猀∀ഀഀ
"Spec_Mode0"	"Cámara desactivada"਍∀嬀攀渀最氀椀猀栀崀匀瀀攀挀开䴀漀搀攀　∀ऀ∀䌀愀洀攀爀愀 䐀椀猀愀戀氀攀搀∀ഀഀ
"Spec_Mode1"	"Cámara de la muerte"਍∀嬀攀渀最氀椀猀栀崀匀瀀攀挀开䴀漀搀攀㄀∀ऀ∀䐀攀愀琀栀 䌀愀洀攀爀愀∀ഀഀ
"Spec_Mode2"	"Vista fija"਍∀嬀攀渀最氀椀猀栀崀匀瀀攀挀开䴀漀搀攀㈀∀ऀ∀䘀椀砀攀搀 嘀椀攀眀∀ഀഀ
"Spec_Mode3"	"Primera persona"਍∀嬀攀渀最氀椀猀栀崀匀瀀攀挀开䴀漀搀攀㌀∀ऀ∀䘀椀爀猀琀 倀攀爀猀漀渀∀ഀഀ
"Spec_Mode4"	"Cámara de seguimiento"਍∀嬀攀渀最氀椀猀栀崀匀瀀攀挀开䴀漀搀攀㐀∀ऀ∀䌀栀愀猀攀 䌀愀洀攀爀愀∀ഀഀ
"Spec_Mode5"	"Mirada libre"਍∀嬀攀渀最氀椀猀栀崀匀瀀攀挀开䴀漀搀攀㔀∀ऀ∀䘀爀攀攀 䰀漀漀欀∀ഀഀ
"Spec_Mode6"	"Vista mapa persecución"਍∀嬀攀渀最氀椀猀栀崀匀瀀攀挀开䴀漀搀攀㘀∀ऀ∀䌀栀愀猀攀 䴀愀瀀 伀瘀攀爀瘀椀攀眀∀ഀഀ
"Spec_NoTarget"	"No hay objetivos válidos. No se puede cambiar el modo de cámara."਍∀嬀攀渀最氀椀猀栀崀匀瀀攀挀开一漀吀愀爀最攀琀∀ऀ∀一漀 瘀愀氀椀搀 琀愀爀最攀琀猀⸀ 䌀愀渀渀漀琀 猀眀椀琀挀栀 挀愀洀攀爀愀 洀漀搀攀⸀∀ഀഀ
"Spec_Options"	"Opciones"਍∀嬀攀渀最氀椀猀栀崀匀瀀攀挀开伀瀀琀椀漀渀猀∀ऀ∀伀瀀琀椀漀渀猀∀ഀഀ
"OBS_NONE"	"Opciones de cámara"਍∀嬀攀渀最氀椀猀栀崀伀䈀匀开一伀一䔀∀ऀ∀䌀愀洀攀爀愀 伀瀀琀椀漀渀猀∀ഀഀ
"OBS_CHASE_LOCKED"	"Cámara persecución fija"਍∀嬀攀渀最氀椀猀栀崀伀䈀匀开䌀䠀䄀匀䔀开䰀伀䌀䬀䔀䐀∀ऀ∀䰀漀挀欀攀搀 䌀栀愀猀攀 䌀愀洀攀爀愀∀ഀഀ
"OBS_CHASE_FREE"	"Cámara persecución libre"਍∀嬀攀渀最氀椀猀栀崀伀䈀匀开䌀䠀䄀匀䔀开䘀刀䔀䔀∀ऀ∀䘀爀攀攀 䌀栀愀猀攀 䌀愀洀攀爀愀∀ഀഀ
"OBS_ROAMING"	"Mirada libre"਍∀嬀攀渀最氀椀猀栀崀伀䈀匀开刀伀䄀䴀䤀一䜀∀ऀ∀䘀爀攀攀 䰀漀漀欀∀ഀഀ
"OBS_IN_EYE"	"Primera persona"਍∀嬀攀渀最氀椀猀栀崀伀䈀匀开䤀一开䔀夀䔀∀ऀ∀䘀椀爀猀琀 倀攀爀猀漀渀∀ഀഀ
"OBS_MAP_FREE"	"Vista mapa libre"਍∀嬀攀渀最氀椀猀栀崀伀䈀匀开䴀䄀倀开䘀刀䔀䔀∀ऀ∀䘀爀攀攀 䴀愀瀀 伀瘀攀爀瘀椀攀眀∀ഀഀ
"OBS_MAP_CHASE"	"Vista mapa persecución"਍∀嬀攀渀最氀椀猀栀崀伀䈀匀开䴀䄀倀开䌀䠀䄀匀䔀∀ऀ∀䌀栀愀猀攀 䴀愀瀀 伀瘀攀爀瘀椀攀眀∀ഀഀ
"SPECT_OPTIONS"	"Opciones"਍∀嬀攀渀最氀椀猀栀崀匀倀䔀䌀吀开伀倀吀䤀伀一匀∀ऀ∀伀瀀琀椀漀渀猀∀ഀഀ
"CAM_OPTIONS"	"Opciones de cámara"਍∀嬀攀渀最氀椀猀栀崀䌀䄀䴀开伀倀吀䤀伀一匀∀ऀ∀䌀愀洀攀爀愀 伀瀀琀椀漀渀猀∀ഀഀ
"PlayerName"	"Nombre"਍∀嬀攀渀最氀椀猀栀崀倀氀愀礀攀爀一愀洀攀∀ऀ∀一愀洀攀∀ഀഀ
"PlayerScore"	"Puntuación"਍∀嬀攀渀最氀椀猀栀崀倀氀愀礀攀爀匀挀漀爀攀∀ऀ∀匀挀漀爀攀∀ഀഀ
"PlayerDeath"	"Bajas"਍∀嬀攀渀最氀椀猀栀崀倀氀愀礀攀爀䐀攀愀琀栀∀ऀ∀䐀攀愀琀栀猀∀ഀഀ
"PlayerPing"	"Latencia"਍∀嬀攀渀最氀椀猀栀崀倀氀愀礀攀爀倀椀渀最∀ऀ∀䰀愀琀攀渀挀礀∀ഀഀ
"PlayerVoice"	"Voz"਍∀嬀攀渀最氀椀猀栀崀倀氀愀礀攀爀嘀漀椀挀攀∀ऀ∀嘀漀椀挀攀∀ഀഀ
"PlayerTracker"	"Amigo"਍∀嬀攀渀最氀椀猀栀崀倀氀愀礀攀爀吀爀愀挀欀攀爀∀ऀ∀䘀爀椀攀渀搀∀ഀഀ
"T0A0TITLE"	"PISTA DE ENTRENAMIENTO"਍∀嬀攀渀最氀椀猀栀崀吀　䄀　吀䤀吀䰀䔀∀ऀ∀䠀䄀娀䄀刀䐀 䌀伀唀刀匀䔀∀ഀഀ
"C0A0TITLE"	"ENTRANDO EN BLACK MESA"਍∀嬀攀渀最氀椀猀栀崀䌀　䄀　吀䤀吀䰀䔀∀ऀ∀䈀䰀䄀䌀䬀 䴀䔀匀䄀 䤀一䈀伀唀一䐀∀ഀഀ
"C0A1TITLE"	"MATERIALES ANÓMALOS"਍∀嬀攀渀最氀椀猀栀崀䌀　䄀㄀吀䤀吀䰀䔀∀ऀ∀䄀一伀䴀䄀䰀伀唀匀 䴀䄀吀䔀刀䤀䄀䰀匀∀ഀഀ
"C1A1TITLE"	"CONSECUENCIAS IMPREVISTAS"਍∀嬀攀渀最氀椀猀栀崀䌀㄀䄀㄀吀䤀吀䰀䔀∀ऀ∀唀一䘀伀刀䔀匀䔀䔀一 䌀伀一匀䔀儀唀䔀一䌀䔀匀∀ഀഀ
"C1A2TITLE"	"COMPLEJO DE OFICINAS"਍∀嬀攀渀最氀椀猀栀崀䌀㄀䄀㈀吀䤀吀䰀䔀∀ऀ∀伀䘀䘀䤀䌀䔀 䌀伀䴀倀䰀䔀堀∀ഀഀ
"C1A3TITLE"	"ENEMIGOS A LA VISTA"਍∀嬀攀渀最氀椀猀栀崀䌀㄀䄀㌀吀䤀吀䰀䔀∀ऀ∀圀䔀✀嘀䔀 䜀伀吀 䠀伀匀吀䤀䰀䔀匀∀ഀഀ
"C1A4TITLE"	"FOSO EXPLOSIVO"਍∀嬀攀渀最氀椀猀栀崀䌀㄀䄀㐀吀䤀吀䰀䔀∀ऀ∀䈀䰀䄀匀吀 倀䤀吀∀ഀഀ
"C2A1TITLE"	"ENERGÍA"਍∀嬀攀渀最氀椀猀栀崀䌀㈀䄀㄀吀䤀吀䰀䔀∀ऀ∀倀伀圀䔀刀 唀倀∀ഀഀ
"C2A2TITLE"	"ENCARRILADO"਍∀嬀攀渀最氀椀猀栀崀䌀㈀䄀㈀吀䤀吀䰀䔀∀ऀ∀伀一 䄀 刀䄀䤀䰀∀ഀഀ
"C2A3TITLE"	"CAPTURA"਍∀嬀攀渀最氀椀猀栀崀䌀㈀䄀㌀吀䤀吀䰀䔀∀ऀ∀䄀倀倀刀䔀䠀䔀一匀䤀伀一∀ഀഀ
"C2A4TITLE1"	"PROCESO DE RESIDUOS"਍∀嬀攀渀最氀椀猀栀崀䌀㈀䄀㐀吀䤀吀䰀䔀㄀∀ऀ∀刀䔀匀䤀䐀唀䔀 倀刀伀䌀䔀匀匀䤀一䜀∀ഀഀ
"C2A4TITLE2"	"ÉTICA DUDOSA"਍∀嬀攀渀最氀椀猀栀崀䌀㈀䄀㐀吀䤀吀䰀䔀㈀∀ऀ∀儀唀䔀匀吀䤀伀一䄀䈀䰀䔀 䔀吀䠀䤀䌀匀∀ഀഀ
"C2A5TITLE"	"TENSIÓN EN LA SUPERFICIE"਍∀嬀攀渀最氀椀猀栀崀䌀㈀䄀㔀吀䤀吀䰀䔀∀ऀ∀匀唀刀䘀䄀䌀䔀 吀䔀一匀䤀伀一∀ഀഀ
"C3A1TITLE"	"¡OLVÍDATE DE FREEMAN!"਍∀嬀攀渀最氀椀猀栀崀䌀㌀䄀㄀吀䤀吀䰀䔀∀ऀ∀䘀伀刀䜀䔀吀 䄀䈀伀唀吀 䘀刀䔀䔀䴀䄀一℀∀ഀഀ
"C3A2TITLE"	"NÚCLEO LAMBDA"਍∀嬀攀渀最氀椀猀栀崀䌀㌀䄀㈀吀䤀吀䰀䔀∀ऀ∀䰀䄀䴀䈀䐀䄀 䌀伀刀䔀∀ഀഀ
"C4A1TITLE"	"XEN"਍∀嬀攀渀最氀椀猀栀崀䌀㐀䄀㄀吀䤀吀䰀䔀∀ऀ∀堀䔀一∀ഀഀ
"C4A1ATITLE"	"INTRUSO"਍∀嬀攀渀最氀椀猀栀崀䌀㐀䄀㄀䄀吀䤀吀䰀䔀∀ऀ∀䤀一吀䔀刀䰀伀倀䔀刀∀ഀഀ
"C4A2TITLE"	"EL ESCONDITE DE GONARCH"਍∀嬀攀渀最氀椀猀栀崀䌀㐀䄀㈀吀䤀吀䰀䔀∀ऀ∀䜀伀一䄀刀䌀䠀✀匀 䰀䄀䤀刀∀ഀഀ
"C4A3TITLE"	"NIHILANTH"਍∀嬀攀渀最氀椀猀栀崀䌀㐀䄀㌀吀䤀吀䰀䔀∀ऀ∀一䤀䠀䤀䰀䄀一吀䠀∀ഀഀ
"C5TITLE"	"FIN DEL JUEGO"਍∀嬀攀渀最氀椀猀栀崀䌀㔀吀䤀吀䰀䔀∀ऀ∀䔀一䐀䜀䄀䴀䔀∀ഀഀ
"Valve_Hostname"	"Nombre de host"਍∀嬀攀渀最氀椀猀栀崀嘀愀氀瘀攀开䠀漀猀琀渀愀洀攀∀ऀ∀䠀漀猀琀渀愀洀攀∀ഀഀ
"Valve_Max_Players"	"Jugadores máx."਍∀嬀攀渀最氀椀猀栀崀嘀愀氀瘀攀开䴀愀砀开倀氀愀礀攀爀猀∀ऀ∀䴀愀砀⸀ 瀀氀愀礀攀爀猀∀ഀഀ
"Valve_Server_Password"	"Contraseña de servidor"਍∀嬀攀渀最氀椀猀栀崀嘀愀氀瘀攀开匀攀爀瘀攀爀开倀愀猀猀眀漀爀搀∀ऀ∀匀攀爀瘀攀爀 瀀愀猀猀眀漀爀搀∀ഀഀ
"Valve_Close"	"Cerrar"਍∀嬀攀渀最氀椀猀栀崀嘀愀氀瘀攀开䌀氀漀猀攀∀ऀ∀䌀氀漀猀攀∀ഀഀ
"Valve_Help"	"Ayuda"਍∀嬀攀渀最氀椀猀栀崀嘀愀氀瘀攀开䠀攀氀瀀∀ऀ∀䠀攀氀瀀∀ഀഀ
"Valve_Settings"	"Parámetros"਍∀嬀攀渀最氀椀猀栀崀嘀愀氀瘀攀开匀攀琀琀椀渀最猀∀ऀ∀匀攀琀琀椀渀最猀∀ഀഀ
"Valve_Chat_Messages"	"Mensajes de chat"਍∀嬀攀渀最氀椀猀栀崀嘀愀氀瘀攀开䌀栀愀琀开䴀攀猀猀愀最攀猀∀ऀ∀䌀栀愀琀 䴀攀猀猀愀最攀猀∀ഀഀ
"Valve_Show_Status"	"Mostrar estado"਍∀嬀攀渀最氀椀猀栀崀嘀愀氀瘀攀开匀栀漀眀开匀琀愀琀甀猀∀ऀ∀匀栀漀眀 匀琀愀琀甀猀∀ഀഀ
"Valve_View_Cone"	"Cono de visión"਍∀嬀攀渀最氀椀猀栀崀嘀愀氀瘀攀开嘀椀攀眀开䌀漀渀攀∀ऀ∀嘀椀攀眀 䌀漀渀攀∀ഀഀ
"Valve_Player_Names"	"Nombres de jugadores"਍∀嬀攀渀最氀椀猀栀崀嘀愀氀瘀攀开倀氀愀礀攀爀开一愀洀攀猀∀ऀ∀倀氀愀礀攀爀 一愀洀攀猀∀ഀഀ
"Valve_PIP"	"Picture-In-Picture"਍∀嬀攀渀最氀椀猀栀崀嘀愀氀瘀攀开倀䤀倀∀ऀ∀倀椀挀琀甀爀攀ⴀ䤀渀ⴀ倀椀挀琀甀爀攀∀ഀഀ
"Valve_Overview"	"Vista general"਍∀嬀攀渀最氀椀猀栀崀嘀愀氀瘀攀开伀瘀攀爀瘀椀攀眀∀ऀ∀伀瘀攀爀瘀椀攀眀∀ഀഀ
"Valve_Overview_Off"	"Sin mapa"਍∀嬀攀渀最氀椀猀栀崀嘀愀氀瘀攀开伀瘀攀爀瘀椀攀眀开伀昀昀∀ऀ∀一漀 䴀愀瀀∀ഀഀ
"Valve_Overview_Small"	"Mapa pequeño"਍∀嬀攀渀最氀椀猀栀崀嘀愀氀瘀攀开伀瘀攀爀瘀椀攀眀开匀洀愀氀氀∀ऀ∀匀洀愀氀氀 䴀愀瀀∀ഀഀ
"Valve_Overview_Large"	"Mapa grande"਍∀嬀攀渀最氀椀猀栀崀嘀愀氀瘀攀开伀瘀攀爀瘀椀攀眀开䰀愀爀最攀∀ऀ∀䰀愀爀最攀 䴀愀瀀∀ഀഀ
"Valve_Overview_ZoomIn"	"Aumentar"਍∀嬀攀渀最氀椀猀栀崀嘀愀氀瘀攀开伀瘀攀爀瘀椀攀眀开娀漀漀洀䤀渀∀ऀ∀娀漀漀洀 䤀渀∀ഀഀ
"Valve_Overview_Zoomout"	"Disminuir"਍∀嬀攀渀最氀椀猀栀崀嘀愀氀瘀攀开伀瘀攀爀瘀椀攀眀开娀漀漀洀漀甀琀∀ऀ∀娀漀漀洀 伀甀琀∀ഀഀ
"Valve_Overview_Locked"	"Sin rotación"਍∀嬀攀渀最氀椀猀栀崀嘀愀氀瘀攀开伀瘀攀爀瘀椀攀眀开䰀漀挀欀攀搀∀ऀ∀一漀 刀漀琀愀琀椀漀渀∀ഀഀ
"Valve_Overview_Names"	"Mostrar nombres"਍∀嬀攀渀最氀椀猀栀崀嘀愀氀瘀攀开伀瘀攀爀瘀椀攀眀开一愀洀攀猀∀ऀ∀匀栀漀眀 一愀洀攀猀∀ഀഀ
"Valve_Overview_Health"	"Mostrar estado"਍∀嬀攀渀最氀椀猀栀崀嘀愀氀瘀攀开伀瘀攀爀瘀椀攀眀开䠀攀愀氀琀栀∀ऀ∀匀栀漀眀 䠀攀愀氀琀栀∀ഀഀ
"Valve_Overview_Tracks"	"Mostrar pistas"਍∀嬀攀渀最氀椀猀栀崀嘀愀氀瘀攀开伀瘀攀爀瘀椀攀眀开吀爀愀挀欀猀∀ऀ∀匀栀漀眀 吀爀愀挀欀猀∀ഀഀ
"Valve_Auto_Director"	"Director automático"਍∀嬀攀渀最氀椀猀栀崀嘀愀氀瘀攀开䄀甀琀漀开䐀椀爀攀挀琀漀爀∀ऀ∀䄀甀琀漀 䐀椀爀攀挀琀漀爀∀ഀഀ
"Valve_Show_Scores"	"Mostrar puntuaciones"਍∀嬀攀渀最氀椀猀栀崀嘀愀氀瘀攀开匀栀漀眀开匀挀漀爀攀猀∀ऀ∀匀栀漀眀 匀挀漀爀攀猀∀ഀഀ
"Valve_Game_Saved"	"Partida guardada"਍∀嬀攀渀最氀椀猀栀崀嘀愀氀瘀攀开䜀愀洀攀开匀愀瘀攀搀∀ऀ∀䜀愀洀攀 匀愀瘀攀搀∀ഀഀ
"Valve_Orange"	"Naranja"਍∀嬀攀渀最氀椀猀栀崀嘀愀氀瘀攀开伀爀愀渀最攀∀ऀ∀伀爀愀渀最攀∀ഀഀ
"Valve_Yellow"	"Amarillo"਍∀嬀攀渀最氀椀猀栀崀嘀愀氀瘀攀开夀攀氀氀漀眀∀ऀ∀夀攀氀氀漀眀∀ഀഀ
"Valve_Blue"	"Azul"਍∀嬀攀渀最氀椀猀栀崀嘀愀氀瘀攀开䈀氀甀攀∀ऀ∀䈀氀甀攀∀ഀഀ
"Valve_Ltblue"	"Azul claro"਍∀嬀攀渀最氀椀猀栀崀嘀愀氀瘀攀开䰀琀戀氀甀攀∀ऀ∀䰀琀戀氀甀攀∀ഀഀ
"Valve_Green"	"Verde"਍∀嬀攀渀最氀椀猀栀崀嘀愀氀瘀攀开䜀爀攀攀渀∀ऀ∀䜀爀攀攀渀∀ഀഀ
"Valve_Red"	"Roja"਍∀嬀攀渀最氀椀猀栀崀嘀愀氀瘀攀开刀攀搀∀ऀ∀刀攀搀∀ഀഀ
"Valve_Brown"	"Marrón"਍∀嬀攀渀最氀椀猀栀崀嘀愀氀瘀攀开䈀爀漀眀渀∀ऀ∀䈀爀漀眀渀∀ഀഀ
"Valve_Ltgray"	"Gris claro"਍∀嬀攀渀最氀椀猀栀崀嘀愀氀瘀攀开䰀琀最爀愀礀∀ऀ∀䰀琀最爀愀礀∀ഀഀ
"Valve_Dkgray"	"Gris oscuro"਍∀嬀攀渀最氀椀猀栀崀嘀愀氀瘀攀开䐀欀最爀愀礀∀ऀ∀䐀欀最爀愀礀∀ഀഀ
"Valve_Playing"	"Jugando"਍∀嬀攀渀最氀椀猀栀崀嘀愀氀瘀攀开倀氀愀礀椀渀最∀ऀ∀倀氀愀礀椀渀最∀ഀഀ
"Valve_Stopped"	"Detenido"਍∀嬀攀渀最氀椀猀栀崀嘀愀氀瘀攀开匀琀漀瀀瀀攀搀∀ऀ∀匀琀漀瀀瀀攀搀∀ഀഀ
"Valve_Paused"	"En pausa"਍∀嬀攀渀最氀椀猀栀崀嘀愀氀瘀攀开倀愀甀猀攀搀∀ऀ∀倀愀甀猀攀搀∀ഀഀ
"Valve_x_1_4"	"x1/4"਍∀嬀攀渀最氀椀猀栀崀嘀愀氀瘀攀开砀开㄀开㐀∀ऀ∀砀㄀⼀㐀∀ഀഀ
"Valve_x_1_2"	"x1/2"਍∀嬀攀渀最氀椀猀栀崀嘀愀氀瘀攀开砀开㄀开㈀∀ऀ∀砀㄀⼀㈀∀ഀഀ
"Valve_x_1"	"x1"਍∀嬀攀渀最氀椀猀栀崀嘀愀氀瘀攀开砀开㄀∀ऀ∀砀㄀∀ഀഀ
"Valve_x_2"	"x2"਍∀嬀攀渀最氀椀猀栀崀嘀愀氀瘀攀开砀开㈀∀ऀ∀砀㈀∀ഀഀ
"Valve_x_4"	"x4"਍∀嬀攀渀最氀椀猀栀崀嘀愀氀瘀攀开砀开㐀∀ऀ∀砀㐀∀ഀഀ
"Valve_ViewDemoStatus"	"%s1  %s2  %s3"਍∀嬀攀渀最氀椀猀栀崀嘀愀氀瘀攀开嘀椀攀眀䐀攀洀漀匀琀愀琀甀猀∀ऀ∀─猀㄀  ─猀㈀  ─猀㌀∀ഀഀ
"Valve_Hint_Zoom"	"%+zoom% AUMENTAR IMAGEN"਍∀嬀攀渀最氀椀猀栀崀嘀愀氀瘀攀开䠀椀渀琀开娀漀漀洀∀ऀ∀─⬀稀漀漀洀─ 娀伀伀䴀 嘀䤀䔀圀∀ഀഀ
"Valve_Hint_machinegun"	"%+USE% PARA USAR PISTOLA MONTADA"਍∀嬀攀渀最氀椀猀栀崀嘀愀氀瘀攀开䠀椀渀琀开洀愀挀栀椀渀攀最甀渀∀ऀ∀─⬀唀匀䔀─ 吀伀 唀匀䔀 䴀伀唀一吀䔀䐀 䜀唀一∀ഀഀ
"Valve_Hint_Flashlight"	"%impulse 100% LINTERNA"਍∀嬀攀渀最氀椀猀栀崀嘀愀氀瘀攀开䠀椀渀琀开䘀氀愀猀栀氀椀最栀琀∀ऀ∀─椀洀瀀甀氀猀攀 ㄀　　─ 䘀䰀䄀匀䠀䰀䤀䜀䠀吀∀ഀഀ
"Valve_Hint_PhysSwap"	"%phys_swap% PARA CAMBIAR LA PISTOLA DE GRAVEDAD\n POR EL ARMA ANTERIOR"਍∀嬀攀渀最氀椀猀栀崀嘀愀氀瘀攀开䠀椀渀琀开倀栀礀猀匀眀愀瀀∀ऀ∀─瀀栀礀猀开猀眀愀瀀─ 吀伀 匀圀䄀倀 䜀刀䄀嘀䤀吀夀 䜀唀一尀渀 圀䤀吀䠀 倀刀䔀嘀䤀伀唀匀 䜀唀一∀ഀഀ
"Valve_Hint_Command_send"	"%impulse 50% MANDAR BATALLÓN A UN SITIO"਍∀嬀攀渀最氀椀猀栀崀嘀愀氀瘀攀开䠀椀渀琀开䌀漀洀洀愀渀搀开猀攀渀搀∀ऀ∀─椀洀瀀甀氀猀攀 㔀　─ 匀䔀一䐀 夀伀唀刀 匀儀唀䄀䐀 吀伀 䄀 䰀伀䌀䄀吀䤀伀一∀ഀഀ
"Valve_Hint_Command_recall"	"%impulse 50% DOS VECES PARA LLAMAR A BATALLÓN"਍∀嬀攀渀最氀椀猀栀崀嘀愀氀瘀攀开䠀椀渀琀开䌀漀洀洀愀渀搀开爀攀挀愀氀氀∀ऀ∀─椀洀瀀甀氀猀攀 㔀　─ 吀圀䤀䌀䔀 吀伀 刀䔀䌀䄀䰀䰀 夀伀唀刀 匀儀唀䄀䐀∀ഀഀ
"Valve_Hint_CraneKeys"	"%+forward% EXTENDER EL BRAZO%+back% RETRAER EL BRAZO %+moveleft% GIRAR A LA IZQUIERDA %+moveright% GIRAR A LA DERECHA %+attack% COGER O SOLTAR OBJETO"	[$WIN32]਍∀嬀攀渀最氀椀猀栀崀嘀愀氀瘀攀开䠀椀渀琀开䌀爀愀渀攀䬀攀礀猀∀ऀ∀─⬀昀漀爀眀愀爀搀─ 䔀堀吀䔀一䐀 䄀刀䴀 ─⬀戀愀挀欀─ 刀䔀吀刀䄀䌀吀 䄀刀䴀 ─⬀洀漀瘀攀氀攀昀琀─ 吀唀刀一 䰀䔀䘀吀 ─⬀洀漀瘀攀爀椀最栀琀─ 吀唀刀一 刀䤀䜀䠀吀 ─⬀愀琀琀愀挀欀─ 倀䤀䌀䬀唀倀 伀刀 䐀刀伀倀 伀䈀䨀䔀䌀吀∀ഀഀ
"Valve_Hint_CraneKeys"	"%xmove% MOVER BRAZO %+attack% COGER/SOLTAR OBJETO"	[$X360]਍∀嬀攀渀最氀椀猀栀崀嘀愀氀瘀攀开䠀椀渀琀开䌀爀愀渀攀䬀攀礀猀∀ऀ∀─砀洀漀瘀攀─ 䴀伀嘀䔀 䄀刀䴀 ─⬀愀琀琀愀挀欀─ 倀䤀䌀䬀唀倀⼀䐀刀伀倀 伀䈀䨀䔀䌀吀∀ഀഀ
"Valve_Hint_BoatKeys"	"%+forward% ACELERAR %+back% REDUCIR VELOCIDAD %+moveleft% GIRAR A LA IZQUIERDA %+moveright% GIRAR A LA DERECHA"	[$WIN32]਍∀嬀攀渀最氀椀猀栀崀嘀愀氀瘀攀开䠀椀渀琀开䈀漀愀琀䬀攀礀猀∀ऀ∀─⬀昀漀爀眀愀爀搀─ 匀倀䔀䔀䐀 唀倀 ─⬀戀愀挀欀─ 匀䰀伀圀 䐀伀圀一 ─⬀洀漀瘀攀氀攀昀琀─ 吀唀刀一 䰀䔀䘀吀 ─⬀洀漀瘀攀爀椀最栀琀─ 吀唀刀一 刀䤀䜀䠀吀∀ഀഀ
"Valve_Hint_BoatKeys"	"%xmove% ACELERAR/CONDUCIR %xlook% VISTA"	[$X360]਍∀嬀攀渀最氀椀猀栀崀嘀愀氀瘀攀开䠀椀渀琀开䈀漀愀琀䬀攀礀猀∀ऀ∀─砀洀漀瘀攀─ 䄀䌀䌀䔀䰀䔀刀䄀吀䔀⼀匀吀䔀䔀刀 ─砀氀漀漀欀─ 䰀伀伀䬀∀ഀഀ
"Valve_Hint_JeepKeys"	"%+speed% TURBO %+jump% FRENO"਍∀嬀攀渀最氀椀猀栀崀嘀愀氀瘀攀开䠀椀渀琀开䨀攀攀瀀䬀攀礀猀∀ऀ∀─⬀猀瀀攀攀搀─ 吀唀刀䈀伀 ─⬀樀甀洀瀀─ 䠀䄀一䐀䈀刀䄀䬀䔀∀ഀഀ
"Valve_Hint_JeepTurbo"	"%+speed% TURBO"਍∀嬀攀渀最氀椀猀栀崀嘀愀氀瘀攀开䠀椀渀琀开䨀攀攀瀀吀甀爀戀漀∀ऀ∀─⬀猀瀀攀攀搀─ 吀唀刀䈀伀∀ഀഀ
"Valve_Hint_HEVcharger"	"%+use% MANTÉN PULSADO PARA CARGAR"਍∀嬀攀渀最氀椀猀栀崀嘀愀氀瘀攀开䠀椀渀琀开䠀䔀嘀挀栀愀爀最攀爀∀ऀ∀─⬀甀猀攀─ 䠀伀䰀䐀 䐀伀圀一 吀伀 䌀䠀䄀刀䜀䔀 匀唀䤀吀∀ഀഀ
"Valve_Hint_AirboatGun"	"%+attack% DISPARAR PROYÉCTIL AGUA-AIRE"਍∀嬀攀渀最氀椀猀栀崀嘀愀氀瘀攀开䠀椀渀琀开䄀椀爀戀漀愀琀䜀甀渀∀ऀ∀─⬀愀琀琀愀挀欀─ 䘀䤀刀䔀 䄀䤀刀䈀伀䄀吀 䜀唀一∀ഀഀ
"Valve_Hint_AmmoCrate"	"%+use% SACAR MUNICIÓN DE LA CAJA"਍∀嬀攀渀最氀椀猀栀崀嘀愀氀瘀攀开䠀椀渀琀开䄀洀洀漀䌀爀愀琀攀∀ऀ∀─⬀甀猀攀─ 䜀䔀吀 䄀䴀䴀伀 䘀刀伀䴀 䌀刀䄀吀䔀∀ഀഀ
"Valve_Hint_USEPickup"	"%+use% RECOGER OBJETO"਍∀嬀攀渀最氀椀猀栀崀嘀愀氀瘀攀开䠀椀渀琀开唀匀䔀倀椀挀欀甀瀀∀ऀ∀─⬀甀猀攀─ 倀䤀䌀䬀唀倀 伀䈀䨀䔀䌀吀∀ഀഀ
"Valve_Hint_ThrowHeld"	"%+attack% ARROJAR OBJETO"਍∀嬀攀渀最氀椀猀栀崀嘀愀氀瘀攀开䠀椀渀琀开吀栀爀漀眀䠀攀氀搀∀ऀ∀─⬀愀琀琀愀挀欀─ 吀䠀刀伀圀 䠀䔀䰀䐀 伀䈀䨀䔀䌀吀∀ഀഀ
"Valve_Hint_MomentaryButton"	"%+use% SOSTENER PARA GIRAR RUEDA"਍∀嬀攀渀最氀椀猀栀崀嘀愀氀瘀攀开䠀椀渀琀开䴀漀洀攀渀琀愀爀礀䈀甀琀琀漀渀∀ऀ∀─⬀甀猀攀─ 䠀伀䰀䐀 䐀伀圀一 吀伀 吀唀刀一 圀䠀䔀䔀䰀∀ഀഀ
"Valve_Hint_ThrowBait"	"%+attack% ARROJAR CARNAZA"਍∀嬀攀渀最氀椀猀栀崀嘀愀氀瘀攀开䠀椀渀琀开吀栀爀漀眀䈀愀椀琀∀ऀ∀─⬀愀琀琀愀挀欀─ 吀䠀刀伀圀 䈀唀䜀䈀䄀䤀吀∀ഀഀ
"Valve_Hint_SqueezeBait"	"%+attack2% LLAMAR A HORMIGAS LEÓN"਍∀嬀攀渀最氀椀猀栀崀嘀愀氀瘀攀开䠀椀渀琀开匀焀甀攀攀稀攀䈀愀椀琀∀ऀ∀─⬀愀琀琀愀挀欀㈀─ 䌀䄀䰀䰀 䄀一吀䰀䤀伀一匀∀ഀഀ
"Valve_Hint_Ladder"	"%+use% MONTAR/DESMONTAR ESCALERILLA"਍∀嬀攀渀最氀椀猀栀崀嘀愀氀瘀攀开䠀椀渀琀开䰀愀搀搀攀爀∀ऀ∀─⬀甀猀攀─ 䴀伀唀一吀⼀䐀䤀匀䴀伀唀一吀 䰀䄀䐀䐀䔀刀∀ഀഀ
"Valve_Hint_Interact"	"%+use% INTERVENIR"਍∀嬀攀渀最氀椀猀栀崀嘀愀氀瘀攀开䠀椀渀琀开䤀渀琀攀爀愀挀琀∀ऀ∀─⬀甀猀攀─ 䤀一吀䔀刀䄀䌀吀∀ഀഀ
"Valve_Hint_Jump"	"%+jump% SALTAR"਍∀嬀攀渀最氀椀猀栀崀嘀愀氀瘀攀开䠀椀渀琀开䨀甀洀瀀∀ऀ∀─⬀樀甀洀瀀─ 䨀唀䴀倀∀ഀഀ
"Valve_Hint_Movement"	"%xmove% MOVER %xlook% MIRAR"	[$X360]਍∀嬀攀渀最氀椀猀栀崀嘀愀氀瘀攀开䠀椀渀琀开䴀漀瘀攀洀攀渀琀∀ऀ∀─砀洀漀瘀攀─ 吀伀 䴀伀嘀䔀 ─砀氀漀漀欀─ 吀伀 䰀伀伀䬀∀ഀഀ
"Valve_Hint_Movement"	"HACIA DELANTE %+forward%ATRÁS %+back%IZQUIERDA %+moveleft%DERECHA %+moveright%"	[$WIN32]਍∀嬀攀渀最氀椀猀栀崀嘀愀氀瘀攀开䠀椀渀琀开䴀漀瘀攀洀攀渀琀∀ऀ∀䘀伀刀圀䄀刀䐀 ─⬀昀漀爀眀愀爀搀─䈀䄀䌀䬀 ─⬀戀愀挀欀─䰀䔀䘀吀 ─⬀洀漀瘀攀氀攀昀琀─刀䤀䜀䠀吀 ─⬀洀漀瘀攀爀椀最栀琀─∀ഀഀ
"Valve_Hint_Door"	"%+use% ABRIR PUERTA"਍∀嬀攀渀最氀椀猀栀崀嘀愀氀瘀攀开䠀椀渀琀开䐀漀漀爀∀ऀ∀─⬀甀猀攀─ 伀倀䔀一 䐀伀伀刀∀ഀഀ
"Valve_Hint_Sprint"	"%+speed% CORRER"਍∀嬀攀渀最氀椀猀栀崀嘀愀氀瘀攀开䠀椀渀琀开匀瀀爀椀渀琀∀ऀ∀─⬀猀瀀攀攀搀─ 匀倀刀䤀一吀∀ഀഀ
"Valve_Hint_Attack"	"%+attack% ATACAR"਍∀嬀攀渀最氀椀猀栀崀嘀愀氀瘀攀开䠀椀渀琀开䄀琀琀愀挀欀∀ऀ∀─⬀愀琀琀愀挀欀─ 䄀吀吀䄀䌀䬀∀ഀഀ
"Valve_Hint_Crouch"	"%+duck% AGACHARSE"਍∀嬀攀渀最氀椀猀栀崀嘀愀氀瘀攀开䠀椀渀琀开䌀爀漀甀挀栀∀ऀ∀─⬀搀甀挀欀─ 䌀刀伀唀䌀䠀∀ഀഀ
"Valve_Hint_ItemCrate"	"%+attack% ROMPER CAJA DE SUMINISTROS PARA CONSEGUIR OBJETOS"਍∀嬀攀渀最氀椀猀栀崀嘀愀氀瘀攀开䠀椀渀琀开䤀琀攀洀䌀爀愀琀攀∀ऀ∀─⬀愀琀琀愀挀欀─ 䈀刀䔀䄀䬀 匀唀倀倀䰀夀 䌀刀䄀吀䔀 䘀伀刀 䤀吀䔀䴀匀∀ഀഀ
"Valve_Hint_Healthcharger"	"%+use% MANTENER PULSADO PARA CURARSE CON UNA UNIDAD MÉDICA"਍∀嬀攀渀最氀椀猀栀崀嘀愀氀瘀攀开䠀椀渀琀开䠀攀愀氀琀栀挀栀愀爀最攀爀∀ऀ∀─⬀甀猀攀─ 䠀伀䰀䐀 吀伀 䠀䔀䄀䰀 䘀刀伀䴀 䴀䔀䐀䤀䌀䄀䰀 唀一䤀吀∀ഀഀ
"Valve_Hint_Reload"	"%+reload% RECARGAR"਍∀嬀攀渀最氀椀猀栀崀嘀愀氀瘀攀开䠀椀渀琀开刀攀氀漀愀搀∀ऀ∀─⬀爀攀氀漀愀搀─ 刀䔀䰀伀䄀䐀∀ഀഀ
"Valve_Hint_SwimUp"	"%+jump% NADAR HACIA ARRIBA"਍∀嬀攀渀最氀椀猀栀崀嘀愀氀瘀攀开䠀椀渀琀开匀眀椀洀唀瀀∀ऀ∀─⬀樀甀洀瀀─ 匀圀䤀䴀 唀倀∀ഀഀ
"Valve_Miscellaneous_Keyboard_Keys_Title"	"MOVIMIENTOS VARIOS"਍∀嬀攀渀最氀椀猀栀崀嘀愀氀瘀攀开䴀椀猀挀攀氀氀愀渀攀漀甀猀开䬀攀礀戀漀愀爀搀开䬀攀礀猀开吀椀琀氀攀∀ऀ∀䴀䤀匀䌀䔀䰀䰀䄀一䔀伀唀匀 䴀伀嘀䔀䴀䔀一吀∀ഀഀ
"Valve_Chapter"	"Capítulo"਍∀嬀攀渀最氀椀猀栀崀嘀愀氀瘀攀开䌀栀愀瀀琀攀爀∀ऀ∀䌀栀愀瀀琀攀爀∀ഀഀ
"Valve_HudPoisonDamage"	"NEUROTOXINA DETECTADA\nADMINISTRANDO ANTÍDOTO"਍∀嬀攀渀最氀椀猀栀崀嘀愀氀瘀攀开䠀甀搀倀漀椀猀漀渀䐀愀洀愀最攀∀ऀ∀一䔀唀刀伀吀伀堀䤀一 䐀䔀吀䔀䌀吀䔀䐀尀渀䄀䐀䴀䤀一䤀匀吀䔀刀䤀一䜀 䄀一吀䤀䐀伀吀䔀∀ഀഀ
"Valve_CreatingCache"	"Creando archivos de sonido en caché..."਍∀嬀攀渀最氀椀猀栀崀嘀愀氀瘀攀开䌀爀攀愀琀椀渀最䌀愀挀栀攀∀ऀ∀䌀爀攀愀琀椀渀最 猀漀甀渀搀 挀愀挀栀攀猀⸀⸀⸀∀ഀഀ
"Valve_CreatingSpecificSoundCache"	"Procesando:  %s1"਍∀嬀攀渀最氀椀猀栀崀嘀愀氀瘀攀开䌀爀攀愀琀椀渀最匀瀀攀挀椀昀椀挀匀漀甀渀搀䌀愀挀栀攀∀ऀ∀倀爀漀挀攀猀猀椀渀最㨀  ─猀㄀∀ഀഀ
"Valve_UpdatingSteamResources"	"Actualizando recursos de Steam..."਍∀嬀攀渀最氀椀猀栀崀嘀愀氀瘀攀开唀瀀搀愀琀椀渀最匀琀攀愀洀刀攀猀漀甀爀挀攀猀∀ऀ∀唀瀀搀愀琀椀渀最 匀琀攀愀洀 爀攀猀漀甀爀挀攀猀⸀⸀⸀∀ഀഀ
"Valve_Sprint"	"Correr (moverse rápidamente)"਍∀嬀攀渀最氀椀猀栀崀嘀愀氀瘀攀开匀瀀爀椀渀琀∀ऀ∀匀瀀爀椀渀琀 ⠀䴀漀瘀攀 儀甀椀挀欀氀礀⤀∀ഀഀ
"Valve_Suit_Zoom"	"Zoom de traje"਍∀嬀攀渀最氀椀猀栀崀嘀愀氀瘀攀开匀甀椀琀开娀漀漀洀∀ऀ∀匀甀椀琀 娀漀漀洀∀ഀഀ
"Valve_Commander_Mode"	"Enviar / retirar al batallón"਍∀嬀攀渀最氀椀猀栀崀嘀愀氀瘀攀开䌀漀洀洀愀渀搀攀爀开䴀漀搀攀∀ऀ∀匀攀渀搀⼀刀攀挀愀氀氀 匀焀甀愀搀∀ഀഀ
"Valve_Gravity_Gun"	"Arma gravitatoria"਍∀嬀攀渀最氀椀猀栀崀嘀愀氀瘀攀开䜀爀愀瘀椀琀礀开䜀甀渀∀ऀ∀䜀爀愀瘀椀琀礀 䜀甀渀∀ഀഀ
"Valve_CC_Toggle"	"Activar/desactivar efectos sonoros de subtítulos"਍∀嬀攀渀最氀椀猀栀崀嘀愀氀瘀攀开䌀䌀开吀漀最最氀攀∀ऀ∀吀漀最最氀攀 挀氀漀猀攀 挀愀瀀琀椀漀渀 猀漀甀渀搀 攀昀昀攀挀琀猀∀ഀഀ
"Valve_Hud_HEALTH"	"SALUD"਍∀嬀攀渀最氀椀猀栀崀嘀愀氀瘀攀开䠀甀搀开䠀䔀䄀䰀吀䠀∀ऀ∀䠀䔀䄀䰀吀䠀∀ഀഀ
"Valve_Hud_AMMO"	"MUNICIÓN"਍∀嬀攀渀最氀椀猀栀崀嘀愀氀瘀攀开䠀甀搀开䄀䴀䴀伀∀ऀ∀䄀䴀䴀伀∀ഀഀ
"Valve_Hud_AMMO_ALT"	"ALT"਍∀嬀攀渀最氀椀猀栀崀嘀愀氀瘀攀开䠀甀搀开䄀䴀䴀伀开䄀䰀吀∀ऀ∀䄀䰀吀∀ഀഀ
"Valve_Hud_SUIT"	"TRAJE"਍∀嬀攀渀最氀椀猀栀崀嘀愀氀瘀攀开䠀甀搀开匀唀䤀吀∀ऀ∀匀唀䤀吀∀ഀഀ
"Valve_Hud_AUX_POWER"	"POT. AUXILIAR"਍∀嬀攀渀最氀椀猀栀崀嘀愀氀瘀攀开䠀甀搀开䄀唀堀开倀伀圀䔀刀∀ऀ∀䄀唀堀 倀伀圀䔀刀∀ഀഀ
"Valve_Hud_OXYGEN"	"OXÍGENO"਍∀嬀攀渀最氀椀猀栀崀嘀愀氀瘀攀开䠀甀搀开伀堀夀䜀䔀一∀ऀ∀伀堀夀䜀䔀一∀ഀഀ
"Valve_Hud_FLASHLIGHT"	"LINTERNA"਍∀嬀攀渀最氀椀猀栀崀嘀愀氀瘀攀开䠀甀搀开䘀䰀䄀匀䠀䰀䤀䜀䠀吀∀ऀ∀䘀䰀䄀匀䠀䰀䤀䜀䠀吀∀ഀഀ
"Valve_Hud_SPRINT"	"CARRERA"਍∀嬀攀渀最氀椀猀栀崀嘀愀氀瘀攀开䠀甀搀开匀倀刀䤀一吀∀ऀ∀匀倀刀䤀一吀∀ഀഀ
"Valve_Hud_BONUS_PROGRESS"	"BONIFICACIÓN"਍∀嬀攀渀最氀椀猀栀崀嘀愀氀瘀攀开䠀甀搀开䈀伀一唀匀开倀刀伀䜀刀䔀匀匀∀ऀ∀䈀伀一唀匀∀ഀഀ
"Valve_Hud_SQUAD_FOLLOWING"	"PELOTÓN EN MARCHA"਍∀嬀攀渀最氀椀猀栀崀嘀愀氀瘀攀开䠀甀搀开匀儀唀䄀䐀开䘀伀䰀䰀伀圀䤀一䜀∀ऀ∀匀儀唀䄀䐀 䘀伀䰀䰀伀圀䤀一䜀∀ഀഀ
"Valve_Hud_SQUAD_STATIONED"	"PELOTÓN DETENIDO"਍∀嬀攀渀最氀椀猀栀崀嘀愀氀瘀攀开䠀甀搀开匀儀唀䄀䐀开匀吀䄀吀䤀伀一䔀䐀∀ऀ∀匀儀唀䄀䐀 匀吀䄀吀䤀伀一䔀䐀∀ഀഀ
"Valve_HDRDEMO_LeftTitle"	"Apertura fija"਍∀嬀攀渀最氀椀猀栀崀嘀愀氀瘀攀开䠀䐀刀䐀䔀䴀伀开䰀攀昀琀吀椀琀氀攀∀ऀ∀䘀椀砀攀搀 䄀瀀攀爀琀甀爀攀∀ഀഀ
"Valve_HDRDEMO_RightTitle"	"HDR (alto rango dinám.)"਍∀嬀攀渀最氀椀猀栀崀嘀愀氀瘀攀开䠀䐀刀䐀䔀䴀伀开刀椀最栀琀吀椀琀氀攀∀ऀ∀䠀椀最栀ⴀ䐀礀渀愀洀椀挀 刀愀渀最攀∀ഀഀ
"Valve_Hud_CamFOV"	"Campo de visión"਍∀嬀攀渀最氀椀猀栀崀嘀愀氀瘀攀开䠀甀搀开䌀愀洀䘀伀嘀∀ऀ∀䘀伀嘀∀ഀഀ
"Valve_Hud_CamHeight"	"Altura de la cámara"਍∀嬀攀渀最氀椀猀栀崀嘀愀氀瘀攀开䠀甀搀开䌀愀洀䠀攀椀最栀琀∀ऀ∀䌀愀洀 䠀攀椀最栀琀∀ഀഀ
"Valve_CamArmLength"	"Longitud del brazo"਍∀嬀攀渀最氀椀猀栀崀嘀愀氀瘀攀开䌀愀洀䄀爀洀䰀攀渀最琀栀∀ऀ∀䄀爀洀 䰀攀渀最琀栀∀ഀഀ
"Valve_FilmDemo_FilmGrain_LeftTitle"	"Sin efecto de película antigua"਍∀嬀攀渀最氀椀猀栀崀嘀愀氀瘀攀开䘀椀氀洀䐀攀洀漀开䘀椀氀洀䜀爀愀椀渀开䰀攀昀琀吀椀琀氀攀∀ऀ∀一漀 䘀椀氀洀 䜀爀愀椀渀∀ഀഀ
"Valve_FilmDemo_FilmGrain_RightTitle"	"Efecto de película antigua"਍∀嬀攀渀最氀椀猀栀崀嘀愀氀瘀攀开䘀椀氀洀䐀攀洀漀开䘀椀氀洀䜀爀愀椀渀开刀椀最栀琀吀椀琀氀攀∀ऀ∀䘀椀氀洀 䜀爀愀椀渀∀ഀഀ
"Valve_FilmDemo_ColorCorrection_LeftTitle"	"Sin corrección de color"਍∀嬀攀渀最氀椀猀栀崀嘀愀氀瘀攀开䘀椀氀洀䐀攀洀漀开䌀漀氀漀爀䌀漀爀爀攀挀琀椀漀渀开䰀攀昀琀吀椀琀氀攀∀ऀ∀一漀 䌀漀氀漀爀 䌀漀爀爀攀挀琀椀漀渀∀ഀഀ
"Valve_FilmDemo_ColorCorrection_RightTitle"	"Corrección de color"਍∀嬀攀渀最氀椀猀栀崀嘀愀氀瘀攀开䘀椀氀洀䐀攀洀漀开䌀漀氀漀爀䌀漀爀爀攀挀琀椀漀渀开刀椀最栀琀吀椀琀氀攀∀ऀ∀䌀漀氀漀爀 䌀漀爀爀攀挀琀椀漀渀∀ഀഀ
"Valve_Hint_Select_Weapon_357"	"%slot1% SELECCIONAR MAGNUM .357"਍∀嬀攀渀最氀椀猀栀崀嘀愀氀瘀攀开䠀椀渀琀开匀攀氀攀挀琀开圀攀愀瀀漀渀开㌀㔀㜀∀ऀ∀─猀氀漀琀㄀─ 匀䔀䰀䔀䌀吀 ⸀㌀㔀㜀 䴀䄀䜀一唀䴀∀ഀഀ
"Valve_Hint_Select_Weapon_AR2"	"%slot2% SELECCIONAR RIFLE DE PULSO"਍∀嬀攀渀最氀椀猀栀崀嘀愀氀瘀攀开䠀椀渀琀开匀攀氀攀挀琀开圀攀愀瀀漀渀开䄀刀㈀∀ऀ∀─猀氀漀琀㈀─ 匀䔀䰀䔀䌀吀 倀唀䰀匀䔀ⴀ刀䤀䘀䰀䔀∀ഀഀ
"Valve_Hint_Select_Weapon_Bugbait"	"%slot4% SELECCIONAR FERÓPODO"਍∀嬀攀渀最氀椀猀栀崀嘀愀氀瘀攀开䠀椀渀琀开匀攀氀攀挀琀开圀攀愀瀀漀渀开䈀甀最戀愀椀琀∀ऀ∀─猀氀漀琀㐀─ 匀䔀䰀䔀䌀吀 倀䠀䔀刀伀倀伀䐀∀ഀഀ
"Valve_Hint_Select_Weapon_Crossbow"	"%slot1% SELECCIONAR BALLESTA"਍∀嬀攀渀最氀椀猀栀崀嘀愀氀瘀攀开䠀椀渀琀开匀攀氀攀挀琀开圀攀愀瀀漀渀开䌀爀漀猀猀戀漀眀∀ऀ∀─猀氀漀琀㄀─ 匀䔀䰀䔀䌀吀 䌀刀伀匀匀䈀伀圀∀ഀഀ
"Valve_Hint_Select_Weapon_Crowbar"	"%slot3% SELECCIONAR PALANCA"਍∀嬀攀渀最氀椀猀栀崀嘀愀氀瘀攀开䠀椀渀琀开匀攀氀攀挀琀开圀攀愀瀀漀渀开䌀爀漀眀戀愀爀∀ऀ∀─猀氀漀琀㌀─ 匀䔀䰀䔀䌀吀 䌀刀伀圀䈀䄀刀∀ഀഀ
"Valve_Hint_Select_Weapon_Frag"	"%slot4% SELECCIONAR GRANADA"਍∀嬀攀渀最氀椀猀栀崀嘀愀氀瘀攀开䠀椀渀琀开匀攀氀攀挀琀开圀攀愀瀀漀渀开䘀爀愀最∀ऀ∀─猀氀漀琀㐀─ 匀䔀䰀䔀䌀吀 䜀刀䔀一䄀䐀䔀∀ഀഀ
"Valve_Hint_Select_Weapon_Physcannon"	"%slot3% SELECCIONAR PISTOLA ANTIGRAVEDAD"਍∀嬀攀渀最氀椀猀栀崀嘀愀氀瘀攀开䠀椀渀琀开匀攀氀攀挀琀开圀攀愀瀀漀渀开倀栀礀猀挀愀渀渀漀渀∀ऀ∀─猀氀漀琀㌀─ 匀䔀䰀䔀䌀吀 䜀刀䄀嘀䤀吀夀 䜀唀一∀ഀഀ
"Valve_Hint_Select_Weapon_Pistol"	"%slot1% SELECCIONAR PISTOLA DE 9 MM"਍∀嬀攀渀最氀椀猀栀崀嘀愀氀瘀攀开䠀椀渀琀开匀攀氀攀挀琀开圀攀愀瀀漀渀开倀椀猀琀漀氀∀ऀ∀─猀氀漀琀㄀─ 匀䔀䰀䔀䌀吀 㤀䴀䴀 倀䤀匀吀伀䰀∀ഀഀ
"Valve_Hint_Select_Weapon_RPG"	"%slot4% SELECCIONAR RPG"਍∀嬀攀渀最氀椀猀栀崀嘀愀氀瘀攀开䠀椀渀琀开匀攀氀攀挀琀开圀攀愀瀀漀渀开刀倀䜀∀ऀ∀─猀氀漀琀㐀─ 匀䔀䰀䔀䌀吀 刀倀䜀∀ഀഀ
"Valve_Hint_Select_Weapon_Shotgun"	"%slot2% SELECCIONAR ESCOPETA"਍∀嬀攀渀最氀椀猀栀崀嘀愀氀瘀攀开䠀椀渀琀开匀攀氀攀挀琀开圀攀愀瀀漀渀开匀栀漀琀最甀渀∀ऀ∀─猀氀漀琀㈀─ 匀䔀䰀䔀䌀吀 匀䠀伀吀䜀唀一∀ഀഀ
"Valve_Hint_Select_Weapon_SMG1"	"%slot2% SELECCIONAR METRALLETA"਍∀嬀攀渀最氀椀猀栀崀嘀愀氀瘀攀开䠀椀渀琀开匀攀氀攀挀琀开圀攀愀瀀漀渀开匀䴀䜀㄀∀ऀ∀─猀氀漀琀㈀─ 匀䔀䰀䔀䌀吀 匀唀䈀䴀䄀䌀䠀䤀一䔀 䜀唀一∀ഀഀ
"Valve_Hint_Select_WEAPONUP"	"%slot1% SELECCIONAR ARMA"਍∀嬀攀渀最氀椀猀栀崀嘀愀氀瘀攀开䠀椀渀琀开匀攀氀攀挀琀开圀䔀䄀倀伀一唀倀∀ऀ∀─猀氀漀琀㄀─ 匀䔀䰀䔀䌀吀 圀䔀䄀倀伀一∀ഀഀ
"Valve_Hint_Select_WEAPONRIGHT"	"%slot2% SELECCIONAR ARMA"਍∀嬀攀渀最氀椀猀栀崀嘀愀氀瘀攀开䠀椀渀琀开匀攀氀攀挀琀开圀䔀䄀倀伀一刀䤀䜀䠀吀∀ऀ∀─猀氀漀琀㈀─ 匀䔀䰀䔀䌀吀 圀䔀䄀倀伀一∀ഀഀ
"Valve_Hint_Select_WEAPONDOWN"	"%slot3% SELECCIONAR ARMA"਍∀嬀攀渀最氀椀猀栀崀嘀愀氀瘀攀开䠀椀渀琀开匀攀氀攀挀琀开圀䔀䄀倀伀一䐀伀圀一∀ऀ∀─猀氀漀琀㌀─ 匀䔀䰀䔀䌀吀 圀䔀䄀倀伀一∀ഀഀ
"Valve_Hint_Select_WEAPONLEFT"	"%slot4% SELECCIONAR ARMA"਍∀嬀攀渀最氀椀猀栀崀嘀愀氀瘀攀开䠀椀渀琀开匀攀氀攀挀琀开圀䔀䄀倀伀一䰀䔀䘀吀∀ऀ∀─猀氀漀琀㐀─ 匀䔀䰀䔀䌀吀 圀䔀䄀倀伀一∀ഀഀ
"Valve_Hint_Alt_Weapon_SMG1"	"%+attack2% DISPARAR CON METRALLETA LANZAGRANADAS"਍∀嬀攀渀最氀椀猀栀崀嘀愀氀瘀攀开䠀椀渀琀开䄀氀琀开圀攀愀瀀漀渀开匀䴀䜀㄀∀ऀ∀─⬀愀琀琀愀挀欀㈀─ 䘀䤀刀䔀 匀䴀䜀 䜀刀䔀一䄀䐀䔀∀ഀഀ
"Valve_Hint_Alt_Weapon_Crossbow"	"%+attack2% MIRA DE LA BALLESTA"਍∀嬀攀渀最氀椀猀栀崀嘀愀氀瘀攀开䠀椀渀琀开䄀氀琀开圀攀愀瀀漀渀开䌀爀漀猀猀戀漀眀∀ऀ∀─⬀愀琀琀愀挀欀㈀─ 䌀刀伀匀匀䈀伀圀 匀䌀伀倀䔀∀ഀഀ
"Valve_Hint_Alt_Weapon_AR2"	"%+attack2% PULSO CARGADO"਍∀嬀攀渀最氀椀猀栀崀嘀愀氀瘀攀开䠀椀渀琀开䄀氀琀开圀攀愀瀀漀渀开䄀刀㈀∀ऀ∀─⬀愀琀琀愀挀欀㈀─ 䌀䠀䄀刀䜀䔀䐀 倀唀䰀匀䔀∀ഀഀ
"Valve_Hint_Alt_Weapon_Shotgun"	"%+attack% DISPARAR CON UN CAÑÓN %+attack2% DISPARAR CON DOS CAÑONES"਍∀嬀攀渀最氀椀猀栀崀嘀愀氀瘀攀开䠀椀渀琀开䄀氀琀开圀攀愀瀀漀渀开匀栀漀琀最甀渀∀ऀ∀─⬀愀琀琀愀挀欀─ 䘀䤀刀䔀 伀一䔀 䈀䄀刀刀䔀䰀 ─⬀愀琀琀愀挀欀㈀─ 䘀䤀刀䔀 䈀伀吀䠀 䈀䄀刀刀䔀䰀匀∀ഀഀ
"Valve_Hint_Alt_Weapon_Frag"	"%+attack% LANZAR GRANADA %+attack2% DEJAR GRANADA"਍∀嬀攀渀最氀椀猀栀崀嘀愀氀瘀攀开䠀椀渀琀开䄀氀琀开圀攀愀瀀漀渀开䘀爀愀最∀ऀ∀─⬀愀琀琀愀挀欀─ 吀䠀刀伀圀 䜀刀䔀一䄀䐀䔀 ─⬀愀琀琀愀挀欀㈀─ 䐀刀伀倀 䜀刀䔀一䄀䐀䔀∀ഀഀ
"Valve_Hint_Alt_Weapon_Bugbait"	"%+attack% LANZAR FERÓPODO %+attack2% ESTRUJAR FERÓPODO"਍∀嬀攀渀最氀椀猀栀崀嘀愀氀瘀攀开䠀椀渀琀开䄀氀琀开圀攀愀瀀漀渀开䈀甀最戀愀椀琀∀ऀ∀─⬀愀琀琀愀挀欀─ 吀䠀刀伀圀 倀䠀䔀刀伀倀伀䐀 ─⬀愀琀琀愀挀欀㈀─ 匀儀唀䔀䔀娀䔀 倀䠀䔀刀伀倀伀䐀∀ഀഀ
"Valve_Hint_Alt_Weapon_Physcannon"	"%+attack% LANZAR OBJETO %+attack2% COGER OBJETO"਍∀嬀攀渀最氀椀猀栀崀嘀愀氀瘀攀开䠀椀渀琀开䄀氀琀开圀攀愀瀀漀渀开倀栀礀猀挀愀渀渀漀渀∀ऀ∀─⬀愀琀琀愀挀欀─ 䰀䄀唀一䌀䠀 伀䈀䨀䔀䌀吀 ─⬀愀琀琀愀挀欀㈀─ 䜀刀䄀䈀 伀䈀䨀䔀䌀吀∀ഀഀ
"Valve_Hint_EnterVehicle"	"%+use% SUBIR A VEHÍCULO"਍∀嬀攀渀最氀椀猀栀崀嘀愀氀瘀攀开䠀椀渀琀开䔀渀琀攀爀嘀攀栀椀挀氀攀∀ऀ∀─⬀甀猀攀─ 䔀一吀䔀刀 嘀䔀䠀䤀䌀䰀䔀∀ഀഀ
"Commentary_PrimaryAttack"	"%+attack%: Iniciar/detener nodo"਍∀嬀攀渀最氀椀猀栀崀䌀漀洀洀攀渀琀愀爀礀开倀爀椀洀愀爀礀䄀琀琀愀挀欀∀ऀ∀─⬀愀琀琀愀挀欀─㨀 匀琀愀爀琀⼀匀琀漀瀀 渀漀搀攀∀ഀഀ
"Commentary_SecondaryAttack"	"%+attack2%: Siguiente nodo"਍∀嬀攀渀最氀椀猀栀崀䌀漀洀洀攀渀琀愀爀礀开匀攀挀漀渀搀愀爀礀䄀琀琀愀挀欀∀ऀ∀─⬀愀琀琀愀挀欀㈀─㨀 一攀砀琀 渀漀搀攀∀ഀഀ
"game_player_joined_game"	"El jugador %s1 se ha incorporado a la partida"਍∀嬀攀渀最氀椀猀栀崀最愀洀攀开瀀氀愀礀攀爀开樀漀椀渀攀搀开最愀洀攀∀ऀ∀倀氀愀礀攀爀 ─猀㄀ 栀愀猀 樀漀椀渀攀搀 琀栀攀 最愀洀攀∀ഀഀ
"game_player_left_game"	"El jugador %s1 ha abandonado la partida (%s2)"	[$WIN32]਍∀嬀攀渀最氀椀猀栀崀最愀洀攀开瀀氀愀礀攀爀开氀攀昀琀开最愀洀攀∀ऀ∀倀氀愀礀攀爀 ─猀㄀ 氀攀昀琀 琀栀攀 最愀洀攀 ⠀─猀㈀⤀∀ഀഀ
"game_player_left_game"	"El jugador %s1 ha abandonado la partida"	[$X360]਍∀嬀攀渀最氀椀猀栀崀最愀洀攀开瀀氀愀礀攀爀开氀攀昀琀开最愀洀攀∀ऀ∀倀氀愀礀攀爀 ─猀㄀ 氀攀昀琀 琀栀攀 最愀洀攀∀ഀഀ
"game_player_joined_team"	"El jugador %s1 se ha unido al equipo %s2"਍∀嬀攀渀最氀椀猀栀崀最愀洀攀开瀀氀愀礀攀爀开樀漀椀渀攀搀开琀攀愀洀∀ऀ∀倀氀愀礀攀爀 ─猀㄀ 樀漀椀渀攀搀 琀攀愀洀 ─猀㈀∀ഀഀ
"game_player_joined_autoteam"	"El jugador %s1 ha sido asignado automáticamente al equipo %s2"਍∀嬀攀渀最氀椀猀栀崀最愀洀攀开瀀氀愀礀攀爀开樀漀椀渀攀搀开愀甀琀漀琀攀愀洀∀ऀ∀倀氀愀礀攀爀 ─猀㄀ 眀愀猀 愀甀琀漀洀愀琀椀挀愀氀氀礀 愀猀猀椀最渀攀搀 琀漀 琀攀愀洀 ─猀㈀∀ഀഀ
"game_player_changed_name"	"El jugador %s1 se llama ahora %s2"਍∀嬀攀渀最氀椀猀栀崀最愀洀攀开瀀氀愀礀攀爀开挀栀愀渀最攀搀开渀愀洀攀∀ऀ∀倀氀愀礀攀爀 ─猀㄀ 挀栀愀渀最攀搀 渀愀洀攀 琀漀 ─猀㈀∀ഀഀ
"game_server_cvar_changed"	"El cvar '%s1' del servidor se ha cambiado por %s2"਍∀嬀攀渀最氀椀猀栀崀最愀洀攀开猀攀爀瘀攀爀开挀瘀愀爀开挀栀愀渀最攀搀∀ऀ∀匀攀爀瘀攀爀 挀瘀愀爀 ✀─猀㄀✀ 挀栀愀渀最攀搀 琀漀 ─猀㈀∀ഀഀ
"Achievement_Earned"	"%s1 ha conseguido el logro %s2"਍∀嬀攀渀最氀椀猀栀崀䄀挀栀椀攀瘀攀洀攀渀琀开䔀愀爀渀攀搀∀ऀ∀̀─猀㄀Ā 栀愀猀 攀愀爀渀攀搀 琀栀攀 愀挀栀椀攀瘀攀洀攀渀琀 Ԁ─猀㈀∀ഀഀ
"game_nextmap"	"Siguiente mapa: %s1"਍∀嬀攀渀最氀椀猀栀崀最愀洀攀开渀攀砀琀洀愀瀀∀ऀ∀一攀砀琀 洀愀瀀 㨀 ─猀㄀∀ഀഀ
"game_takesshots"	"Guardar automáticamente una tabla de puntuaciones al finalizar un mapa."਍∀嬀攀渀最氀椀猀栀崀最愀洀攀开琀愀欀攀猀猀栀漀琀猀∀ऀ∀䄀甀琀漀ⴀ猀愀瘀攀 愀 猀挀漀爀攀戀漀愀爀搀 猀挀爀攀攀渀猀栀漀琀 愀琀 琀栀攀 攀渀搀 漀昀 愀 洀愀瀀⸀∀ഀഀ
"Cannot_Be_Spectator"	"Este servidor no permite espectadores"਍∀嬀攀渀最氀椀猀栀崀䌀愀渀渀漀琀开䈀攀开匀瀀攀挀琀愀琀漀爀∀ऀ∀吀栀椀猀 猀攀爀瘀攀爀 搀漀攀猀 渀漀琀 愀氀氀漀眀 猀瀀攀挀琀愀琀椀渀最∀ഀഀ
"Valve_UseSteamCloud"	"Sincronizar con Steam Cloud."਍∀嬀攀渀最氀椀猀栀崀嘀愀氀瘀攀开唀猀攀匀琀攀愀洀䌀氀漀甀搀∀ऀ∀匀礀渀挀栀爀漀渀椀稀攀 眀椀琀栀 琀栀攀 匀琀攀愀洀 䌀氀漀甀搀⸀∀ഀഀ
"Valve_DisableHTMLMOTD"	"Desactivar MOTDs HTML."਍∀嬀攀渀最氀椀猀栀崀嘀愀氀瘀攀开䐀椀猀愀戀氀攀䠀吀䴀䰀䴀伀吀䐀∀ऀ∀䐀椀猀愀戀氀攀 䠀吀䴀䰀 䴀伀吀䐀猀⸀∀ഀഀ
"Valve_SteamScreenshots"	"Guardar capturas en Steam"਍∀嬀攀渀最氀椀猀栀崀嘀愀氀瘀攀开匀琀攀愀洀匀挀爀攀攀渀猀栀漀琀猀∀ऀ∀匀愀瘀攀 猀挀爀攀攀渀猀栀漀琀猀 琀漀 匀琀攀愀洀∀ഀഀ
"ToolNoTargetItems"	"No tienes ningún objeto con el que poder usar esta herramienta."਍∀嬀攀渀最氀椀猀栀崀吀漀漀氀一漀吀愀爀最攀琀䤀琀攀洀猀∀ऀ∀夀漀甀 搀漀渀✀琀 栀愀瘀攀 愀渀礀 攀氀椀最椀戀氀攀 椀琀攀洀猀 琀漀 甀猀攀 眀椀琀栀 琀栀椀猀 琀漀漀氀⸀∀ഀഀ
"ValveEcon_RootUI_Title"	"GESTIÓN DE OBJETOS"਍∀嬀攀渀最氀椀猀栀崀嘀愀氀瘀攀䔀挀漀渀开刀漀漀琀唀䤀开吀椀琀氀攀∀ऀ∀䤀吀䔀䴀 䴀䄀一䄀䜀䔀䴀䔀一吀∀ഀഀ
"ValveEcon_RootUI_OpenStore"	"Tienda"਍∀嬀攀渀最氀椀猀栀崀嘀愀氀瘀攀䔀挀漀渀开刀漀漀琀唀䤀开伀瀀攀渀匀琀漀爀攀∀ऀ∀匀琀漀爀攀∀ഀഀ
"ValveEcon_RootUI_OpenLoadout"	"Equipamiento"਍∀嬀攀渀最氀椀猀栀崀嘀愀氀瘀攀䔀挀漀渀开刀漀漀琀唀䤀开伀瀀攀渀䰀漀愀搀漀甀琀∀ऀ∀䰀漀愀搀漀甀琀∀ഀഀ
"ValveEcon_RootUI_OpenBackpack"	"Mochila"਍∀嬀攀渀最氀椀猀栀崀嘀愀氀瘀攀䔀挀漀渀开刀漀漀琀唀䤀开伀瀀攀渀䈀愀挀欀瀀愀挀欀∀ऀ∀䈀愀挀欀瀀愀挀欀∀ഀഀ
"ValveEcon_RootUI_OpenCrafting"	"Fabricación"਍∀嬀攀渀最氀椀猀栀崀嘀愀氀瘀攀䔀挀漀渀开刀漀漀琀唀䤀开伀瀀攀渀䌀爀愀昀琀椀渀最∀ऀ∀䌀爀愀昀琀椀渀最∀ഀഀ
"ValveEcon_RootUI_OpenTrading"	"Intercambio"਍∀嬀攀渀最氀椀猀栀崀嘀愀氀瘀攀䔀挀漀渀开刀漀漀琀唀䤀开伀瀀攀渀吀爀愀搀椀渀最∀ऀ∀吀爀愀搀椀渀最∀ഀഀ
"Attrib_TradableAfterDate"	"\nIntercambiable a partir del %s1"਍∀嬀攀渀最氀椀猀栀崀䄀琀琀爀椀戀开吀爀愀搀愀戀氀攀䄀昀琀攀爀䐀愀琀攀∀ऀ∀尀渀吀爀愀搀愀戀氀攀 䄀昀琀攀爀㨀 ─猀㄀∀ഀഀ
"Attrib_Store_TradableAfterDate"	"Se vuelve intercambiable tras unos días"਍∀嬀攀渀最氀椀猀栀崀䄀琀琀爀椀戀开匀琀漀爀攀开吀爀愀搀愀戀氀攀䄀昀琀攀爀䐀愀琀攀∀ऀ∀䈀攀挀漀洀攀猀 吀爀愀搀愀戀氀攀 䄀昀琀攀爀 愀 䘀攀眀 䐀愀礀猀∀ഀഀ
"Attrib_Store_Purchased"	"No será intercambiable ni apto para la fabricación"਍∀嬀攀渀最氀椀猀栀崀䄀琀琀爀椀戀开匀琀漀爀攀开倀甀爀挀栀愀猀攀搀∀ऀ∀圀椀氀氀 一漀琀 䈀攀 吀爀愀搀愀戀氀攀 漀爀 唀猀愀戀氀攀 椀渀 䌀爀愀昀琀椀渀最∀ഀഀ
"Attrib_Purchased"	"Comprado: no intercambiable ni utilizable en la fabricación"਍∀嬀攀渀最氀椀猀栀崀䄀琀琀爀椀戀开倀甀爀挀栀愀猀攀搀∀ऀ∀倀甀爀挀栀愀猀攀搀㨀 一漀琀 吀爀愀搀愀戀氀攀 漀爀 唀猀愀戀氀攀 椀渀 䌀爀愀昀琀椀渀最∀ഀഀ
"Attrib_Promotion"	"Objeto promocional de la tienda: no intercambiable"਍∀嬀攀渀最氀椀猀栀崀䄀琀琀爀椀戀开倀爀漀洀漀琀椀漀渀∀ऀ∀匀琀漀爀攀 倀爀漀洀漀琀椀漀渀 䤀琀攀洀㨀 一漀琀 吀爀愀搀愀戀氀攀∀ഀഀ
"Attrib_AchievementItem"	"Objeto obtenido por logro: no intercambiable"਍∀嬀攀渀最氀椀猀栀崀䄀琀琀爀椀戀开䄀挀栀椀攀瘀攀洀攀渀琀䤀琀攀洀∀ऀ∀䄀挀栀椀攀瘀攀洀攀渀琀 䤀琀攀洀㨀 一漀琀 吀爀愀搀愀戀氀攀∀ഀഀ
"Attrib_CannotTrade"	"No intercambiable"਍∀嬀攀渀最氀椀猀栀崀䄀琀琀爀椀戀开䌀愀渀渀漀琀吀爀愀搀攀∀ऀ∀一漀琀 吀爀愀搀愀戀氀攀∀ഀഀ
"Attrib_CannotCraft"	"No utilizable en la fabricación"਍∀嬀攀渀最氀椀猀栀崀䄀琀琀爀椀戀开䌀愀渀渀漀琀䌀爀愀昀琀∀ऀ∀一漀琀 唀猀愀戀氀攀 椀渀 䌀爀愀昀琀椀渀最∀ഀഀ
"Attrib_SpecialItem"	"No intercambiable ni utilizable en la fabricación"਍∀嬀攀渀最氀椀猀栀崀䄀琀琀爀椀戀开匀瀀攀挀椀愀氀䤀琀攀洀∀ऀ∀一漀琀 吀爀愀搀愀戀氀攀 漀爀 唀猀愀戀氀攀 椀渀 䌀爀愀昀琀椀渀最∀ഀഀ
"Attrib_GifterAccountID"	"\nRegalo de %s1"਍∀嬀攀渀最氀椀猀栀崀䄀琀琀爀椀戀开䜀椀昀琀攀爀䄀挀挀漀甀渀琀䤀䐀∀ऀ∀尀渀䜀椀昀琀 昀爀漀洀㨀 ─猀㄀∀ഀഀ
"Attrib_ReferencedItem"	"Contiene: %s1"਍∀嬀攀渀最氀椀猀栀崀䄀琀琀爀椀戀开刀攀昀攀爀攀渀挀攀搀䤀琀攀洀∀ऀ∀䌀漀渀琀愀椀渀猀㨀 ─猀㄀∀ഀഀ
"Attrib_CustomDesc"	"Este objeto ha sido descrito por el usuario:"਍∀嬀攀渀最氀椀猀栀崀䄀琀琀爀椀戀开䌀甀猀琀漀洀䐀攀猀挀∀ऀ∀吀栀椀猀 椀琀攀洀 栀愀猀 愀 甀猀攀爀 眀爀椀琀琀攀渀 搀攀猀挀爀椀瀀琀椀漀渀㨀∀ഀഀ
"Attrib_Renamed"	"Este objeto ha sido renombrado.\nSu nombre original: \"%s1\""਍∀嬀攀渀最氀椀猀栀崀䄀琀琀爀椀戀开刀攀渀愀洀攀搀∀ऀ∀吀栀椀猀 椀琀攀洀 栀愀猀 戀攀攀渀 爀攀渀愀洀攀搀⸀尀渀伀爀椀最椀渀愀氀 渀愀洀攀㨀 尀∀─猀㄀尀∀∀ഀഀ
"Attrib_LimitedUse"	"Objeto con límite de usos. Usos restantes: %s1"਍∀嬀攀渀最氀椀猀栀崀䄀琀琀爀椀戀开䰀椀洀椀琀攀搀唀猀攀∀ऀ∀吀栀椀猀 椀猀 愀 氀椀洀椀琀攀搀 甀猀攀 椀琀攀洀⸀  唀猀攀猀㨀 ─猀㄀∀ഀഀ
"Attrib_EventDate"	"Fecha de recepción: %s1"਍∀嬀攀渀最氀椀猀栀崀䄀琀琀爀椀戀开䔀瘀攀渀琀䐀愀琀攀∀ऀ∀䐀愀琀攀 刀攀挀攀椀瘀攀搀㨀 ─猀㄀∀ഀഀ
"Attrib_InUse"	"Actualmente en uso"਍∀嬀攀渀最氀椀猀栀崀䄀琀琀爀椀戀开䤀渀唀猀攀∀ऀ∀䌀甀爀爀攀渀琀氀礀 䤀渀 唀猀攀∀ഀഀ
"Attrib_Community_Description"	"Se otorga a los más valiosos colaboradores de la Comunidad"਍∀嬀攀渀最氀椀猀栀崀䄀琀琀爀椀戀开䌀漀洀洀甀渀椀琀礀开䐀攀猀挀爀椀瀀琀椀漀渀∀ऀ∀䜀椀瘀攀渀 琀漀 瘀愀氀甀愀戀氀攀 䌀漀洀洀甀渀椀琀礀 䌀漀渀琀爀椀戀甀琀漀爀猀∀ഀഀ
"Attrib_Selfmade_Description"	"¡Lo hice yo!"਍∀嬀攀渀最氀椀猀栀崀䄀琀琀爀椀戀开匀攀氀昀洀愀搀攀开䐀攀猀挀爀椀瀀琀椀漀渀∀ऀ∀䤀 洀愀搀攀 琀栀椀猀℀∀ഀഀ
"Item_Found"	"%s1 ha encontrado:: %s2 %s3"਍∀嬀攀渀最氀椀猀栀崀䤀琀攀洀开䘀漀甀渀搀∀ऀ∀̀─猀㄀Ā 栀愀猀 昀漀甀渀搀㨀㨀 ─猀㈀ ─猀㌀∀ഀഀ
"Item_Crafted"	"%s1 ha fabricado:: %s2 %s3"਍∀嬀攀渀最氀椀猀栀崀䤀琀攀洀开䌀爀愀昀琀攀搀∀ऀ∀̀─猀㄀Ā 栀愀猀 挀爀愀昀琀攀搀㨀㨀 ─猀㈀ ─猀㌀∀ഀഀ
"Item_Traded"	"%s1 ha recibido en un intercambio:: %s2 %s3"਍∀嬀攀渀最氀椀猀栀崀䤀琀攀洀开吀爀愀搀攀搀∀ऀ∀̀─猀㄀Ā 栀愀猀 琀爀愀搀攀搀 昀漀爀㨀㨀 ─猀㈀ ─猀㌀∀ഀഀ
"Item_Purchased"	"%s1 ha comprado:: %s2 %s3"਍∀嬀攀渀最氀椀猀栀崀䤀琀攀洀开倀甀爀挀栀愀猀攀搀∀ऀ∀̀─猀㄀Ā 栀愀猀 瀀甀爀挀栀愀猀攀搀㨀㨀 ─猀㈀ ─猀㌀∀ഀഀ
"Item_FoundInCrate"	"%s1 ha abierto:: %s2 %s3"਍∀嬀攀渀最氀椀猀栀崀䤀琀攀洀开䘀漀甀渀搀䤀渀䌀爀愀琀攀∀ऀ∀̀─猀㄀Ā 栀愀猀 甀渀戀漀砀攀搀㨀㨀 ─猀㈀ ─猀㌀∀ഀഀ
"Item_Gifted"	"%s1 ha recibido un regalo:: %s2 %s3"਍∀嬀攀渀最氀椀猀栀崀䤀琀攀洀开䜀椀昀琀攀搀∀ऀ∀̀─猀㄀Ā 栀愀猀 爀攀挀攀椀瘀攀搀 愀 最椀昀琀㨀㨀 ─猀㈀ ─猀㌀∀ഀഀ
"Item_Earned"	"%s1 ha obtenido:: %s2 %s3"਍∀嬀攀渀最氀椀猀栀崀䤀琀攀洀开䔀愀爀渀攀搀∀ऀ∀̀─猀㄀Ā 栀愀猀 攀愀爀渀攀搀㨀㨀 ─猀㈀ ─猀㌀∀ഀഀ
"Item_Refunded"	"%s1 se ha reembolsado:: %s2 %s3"਍∀嬀攀渀最氀椀猀栀崀䤀琀攀洀开刀攀昀甀渀搀攀搀∀ऀ∀̀─猀㄀Ā 栀愀猀 戀攀攀渀 爀攀昀甀渀搀攀搀㨀㨀 ─猀㈀ ─猀㌀∀ഀഀ
"Item_GiftWrapped"	"%s1 ha envuelto un regalo:: %s2 %s3"਍∀嬀攀渀最氀椀猀栀崀䤀琀攀洀开䜀椀昀琀圀爀愀瀀瀀攀搀∀ऀ∀̀─猀㄀Ā 栀愀猀 眀爀愀瀀瀀攀搀 愀 最椀昀琀㨀㨀 ─猀㈀ ─猀㌀∀ഀഀ
"Item"	"Objeto"਍∀嬀攀渀最氀椀猀栀崀䤀琀攀洀∀ऀ∀䤀琀攀洀∀ഀഀ
"SelectedItemNumber"	"#%selecteditem%"਍∀嬀攀渀最氀椀猀栀崀匀攀氀攀挀琀攀搀䤀琀攀洀一甀洀戀攀爀∀ऀ∀⌀─猀攀氀攀挀琀攀搀椀琀攀洀─∀ഀഀ
"NewItemsAcquired"	"¡%numitems% OBJETOS NUEVOS ADQUIRIDOS!"਍∀嬀攀渀最氀椀猀栀崀一攀眀䤀琀攀洀猀䄀挀焀甀椀爀攀搀∀ऀ∀─渀甀洀椀琀攀洀猀─ 一䔀圀 䤀吀䔀䴀匀 䄀䌀儀唀䤀刀䔀䐀℀∀ഀഀ
"NewItemAcquired"	"¡OBJETO NUEVO ADQUIRIDO!"਍∀嬀攀渀最氀椀猀栀崀一攀眀䤀琀攀洀䄀挀焀甀椀爀攀搀∀ऀ∀一䔀圀 䤀吀䔀䴀 䄀䌀儀唀䤀刀䔀䐀℀∀ഀഀ
"NewItemsCrafted"	"¡%numitems% NUEVOS OBJETOS FABRICADOS!"਍∀嬀攀渀最氀椀猀栀崀一攀眀䤀琀攀洀猀䌀爀愀昀琀攀搀∀ऀ∀─渀甀洀椀琀攀洀猀─ 一䔀圀 䤀吀䔀䴀匀 䌀刀䄀䘀吀䔀䐀℀∀ഀഀ
"NewItemCrafted"	"¡NUEVO OBJETO FABRICADO!"਍∀嬀攀渀最氀椀猀栀崀一攀眀䤀琀攀洀䌀爀愀昀琀攀搀∀ऀ∀一䔀圀 䤀吀䔀䴀 䌀刀䄀䘀吀䔀䐀℀∀ഀഀ
"TF_HasNewItems"	"¡Tienes nuevos objetos!"਍∀嬀攀渀最氀椀猀栀崀吀䘀开䠀愀猀一攀眀䤀琀攀洀猀∀ऀ∀夀漀甀 栀愀瘀攀 渀攀眀 椀琀攀洀猀℀∀ഀഀ
"NewItemMethod_Dropped"	"Has encontrado:"਍∀嬀攀渀最氀椀猀栀崀一攀眀䤀琀攀洀䴀攀琀栀漀搀开䐀爀漀瀀瀀攀搀∀ऀ∀夀漀甀 Ȁ䘀漀甀渀搀Ā㨀∀ഀഀ
"NewItemMethod_Crafted"	"Has fabricado:"਍∀嬀攀渀最氀椀猀栀崀一攀眀䤀琀攀洀䴀攀琀栀漀搀开䌀爀愀昀琀攀搀∀ऀ∀夀漀甀 Ȁ䌀爀愀昀琀攀搀Ā㨀∀ഀഀ
"NewItemMethod_Traded"	"Has recibido:"਍∀嬀攀渀最氀椀猀栀崀一攀眀䤀琀攀洀䴀攀琀栀漀搀开吀爀愀搀攀搀∀ऀ∀夀漀甀 Ȁ吀爀愀搀攀搀 昀漀爀Ā㨀∀ഀഀ
"NewItemMethod_Purchased"	"Has comprado:"਍∀嬀攀渀最氀椀猀栀崀一攀眀䤀琀攀洀䴀攀琀栀漀搀开倀甀爀挀栀愀猀攀搀∀ऀ∀夀漀甀 Ȁ倀甀爀挀栀愀猀攀搀Ā㨀∀ഀഀ
"NewItemMethod_FoundInCrate"	"Has abierto:"਍∀嬀攀渀最氀椀猀栀崀一攀眀䤀琀攀洀䴀攀琀栀漀搀开䘀漀甀渀搀䤀渀䌀爀愀琀攀∀ऀ∀夀漀甀 Ȁ唀渀戀漀砀攀搀Ā㨀∀ഀഀ
"NewItemMethod_Gifted"	"Has recibido un regalo:"਍∀嬀攀渀最氀椀猀栀崀一攀眀䤀琀攀洀䴀攀琀栀漀搀开䜀椀昀琀攀搀∀ऀ∀夀漀甀 Ȁ刀攀挀攀椀瘀攀搀 愀 䜀椀昀琀Ā㨀∀ഀഀ
"NewItemMethod_Promotion"	"Has recibido un objeto promocional de la tienda:"਍∀嬀攀渀最氀椀猀栀崀一攀眀䤀琀攀洀䴀攀琀栀漀搀开倀爀漀洀漀琀椀漀渀∀ऀ∀夀漀甀 Ȁ刀攀挀攀椀瘀攀搀 愀 匀琀漀爀攀 倀爀漀洀漀琀椀漀渀 䤀琀攀洀Ā㨀∀ഀഀ
"NewItemMethod_Earned"	"Has obtenido:"਍∀嬀攀渀最氀椀猀栀崀一攀眀䤀琀攀洀䴀攀琀栀漀搀开䔀愀爀渀攀搀∀ऀ∀夀漀甀 Ȁ䔀愀爀渀攀搀Ā㨀∀ഀഀ
"NewItemMethod_Refunded"	"Te han devuelto:"਍∀嬀攀渀最氀椀猀栀崀一攀眀䤀琀攀洀䴀攀琀栀漀搀开刀攀昀甀渀搀攀搀∀ऀ∀夀漀甀 Ȁ圀攀爀攀 刀攀昀甀渀搀攀搀Ā㨀∀ഀഀ
"NewItemMethod_Support"	"El servicio de asistencia al cliente te ha concedido:"਍∀嬀攀渀最氀椀猀栀崀一攀眀䤀琀攀洀䴀攀琀栀漀搀开匀甀瀀瀀漀爀琀∀ऀ∀Ȁ䌀甀猀琀漀洀攀爀 匀甀瀀瀀漀爀琀Ā 䜀爀愀渀琀攀搀 夀漀甀㨀∀ഀഀ
"NewItemMethod_Foreign"	"Has encontrado de otro juego:"਍∀嬀攀渀最氀椀猀栀崀一攀眀䤀琀攀洀䴀攀琀栀漀搀开䘀漀爀攀椀最渀∀ऀ∀夀漀甀 䘀漀甀渀搀 Ȁ䘀爀漀洀 䄀渀漀琀栀攀爀 䜀愀洀攀Ā㨀∀ഀഀ
"NextItem"	"VER\nSIGUIENTE >"਍∀嬀攀渀最氀椀猀栀崀一攀砀琀䤀琀攀洀∀ऀ∀嘀䤀䔀圀尀渀一䔀堀吀 㸀∀ഀഀ
"PreviousItem"	"VER\n< ANTERIOR"਍∀嬀攀渀最氀椀猀栀崀倀爀攀瘀椀漀甀猀䤀琀攀洀∀ऀ∀嘀䤀䔀圀尀渀㰀 倀刀䔀嘀∀ഀഀ
"CloseItemPanel"	"VALE, REANUDAR LA PARTIDA"਍∀嬀攀渀最氀椀猀栀崀䌀氀漀猀攀䤀琀攀洀倀愀渀攀氀∀ऀ∀伀䬀Ⰰ 刀䔀匀唀䴀䔀 䜀䄀䴀䔀∀ഀഀ
"OpenGeneralLoadout"	"EQUIPAMIENTO..."਍∀嬀攀渀最氀椀猀栀崀伀瀀攀渀䜀攀渀攀爀愀氀䰀漀愀搀漀甀琀∀ऀ∀伀倀䔀一 䰀伀䄀䐀伀唀吀⸀⸀⸀∀ഀഀ
"OpenBackpack"	"ABRIR MOCHILA..."਍∀嬀攀渀最氀椀猀栀崀伀瀀攀渀䈀愀挀欀瀀愀挀欀∀ऀ∀伀倀䔀一 䈀䄀䌀䬀倀䄀䌀䬀⸀⸀⸀∀ഀഀ
"Store_Price_New"	"¡NUEVO!"਍∀嬀攀渀最氀椀猀栀崀匀琀漀爀攀开倀爀椀挀攀开一攀眀∀ऀ∀一䔀圀℀∀ഀഀ
"Store_Price_Sale"	"¡OFERTA!"਍∀嬀攀渀最氀椀猀栀崀匀琀漀爀攀开倀爀椀挀攀开匀愀氀攀∀ऀ∀匀䄀䰀䔀℀∀ഀഀ
"Store_OK"	"Aceptar"਍∀嬀攀渀最氀椀猀栀崀匀琀漀爀攀开伀䬀∀ऀ∀伀欀愀礀∀ഀഀ
"Store_CANCEL"	"Cancelar"਍∀嬀攀渀最氀椀猀栀崀匀琀漀爀攀开䌀䄀一䌀䔀䰀∀ऀ∀䌀愀渀挀攀氀∀ഀഀ
"Store_NowAvailable"	"YA DISPONIBLE"਍∀嬀攀渀最氀椀猀栀崀匀琀漀爀攀开一漀眀䄀瘀愀椀氀愀戀氀攀∀ऀ∀一伀圀 䄀嘀䄀䤀䰀䄀䈀䰀䔀∀ഀഀ
"Store_ClassFilter_None"	"Todos los objetos"਍∀嬀攀渀最氀椀猀栀崀匀琀漀爀攀开䌀氀愀猀猀䘀椀氀琀攀爀开一漀渀攀∀ऀ∀䄀氀氀 䤀琀攀洀猀∀ഀഀ
"Store_Cart"	"(%s1)"਍∀嬀攀渀最氀椀猀栀崀匀琀漀爀攀开䌀愀爀琀∀ऀ∀⠀─猀㄀⤀∀ഀഀ
"Store_Checkout"	"Pagar"਍∀嬀攀渀最氀椀猀栀崀匀琀漀爀攀开䌀栀攀挀欀漀甀琀∀ऀ∀䌀栀攀挀欀漀甀琀∀ഀഀ
"Store_AddToCart"	"Añadir al carro"਍∀嬀攀渀最氀椀猀栀崀匀琀漀爀攀开䄀搀搀吀漀䌀愀爀琀∀ऀ∀䄀搀搀 琀漀 䌀愀爀琀∀ഀഀ
"StoreViewCartTitle"	"Tu carro de la compra"਍∀嬀攀渀最氀椀猀栀崀匀琀漀爀攀嘀椀攀眀䌀愀爀琀吀椀琀氀攀∀ऀ∀夀漀甀爀 匀栀漀瀀瀀椀渀最 䌀愀爀琀∀ഀഀ
"Store_ContinueShopping"	"Seguir comprando"਍∀嬀攀渀最氀椀猀栀崀匀琀漀爀攀开䌀漀渀琀椀渀甀攀匀栀漀瀀瀀椀渀最∀ऀ∀䌀漀渀琀椀渀甀攀 匀栀漀瀀瀀椀渀最∀ഀഀ
"Store_CartItems"	"%s1 objetos"਍∀嬀攀渀最氀椀猀栀崀匀琀漀爀攀开䌀愀爀琀䤀琀攀洀猀∀ऀ∀─猀㄀ 䤀琀攀洀猀∀ഀഀ
"Store_EstimatedTotal"	"total estimado"਍∀嬀攀渀最氀椀猀栀崀匀琀漀爀攀开䔀猀琀椀洀愀琀攀搀吀漀琀愀氀∀ऀ∀攀猀琀椀洀愀琀攀搀 琀漀琀愀氀∀ഀഀ
"Store_WAStateSalesTax"	"los impuestos de ventas serán calculados para los residentes en el estado de Washington"਍∀嬀攀渀最氀椀猀栀崀匀琀漀爀攀开圀䄀匀琀愀琀攀匀愀氀攀猀吀愀砀∀ऀ∀猀愀氀攀猀 琀愀砀 眀椀氀氀 戀攀 挀愀氀挀甀氀愀琀攀搀 昀漀爀 圀䄀 猀琀愀琀攀 爀攀猀椀搀攀渀琀猀∀ഀഀ
"Store_TotalSubtextB"	"Todos los objetos se añadirán a tu inventario después de la compra"਍∀嬀攀渀最氀椀猀栀崀匀琀漀爀攀开吀漀琀愀氀匀甀戀琀攀砀琀䈀∀ऀ∀愀氀氀 椀琀攀洀猀 眀椀氀氀 愀搀搀攀搀 琀漀 礀漀甀爀 戀愀挀欀瀀愀挀欀 愀昀琀攀爀 瀀甀爀挀栀愀猀攀∀ഀഀ
"Store_Remove"	"Eliminar"਍∀嬀攀渀最氀椀猀栀崀匀琀漀爀攀开刀攀洀漀瘀攀∀ऀ∀刀攀洀漀瘀攀∀ഀഀ
"Store_CartIsEmpty"	"No tienes objetos en tu carro."਍∀嬀攀渀最氀椀猀栀崀匀琀漀爀攀开䌀愀爀琀䤀猀䔀洀瀀琀礀∀ऀ∀夀漀甀 栀愀瘀攀 渀漀 椀琀攀洀猀 椀渀 礀漀甀爀 挀愀爀琀⸀∀ഀഀ
"Store_Wallet"	"Saldo de tu cuenta de Steam: $%s1 ($%s2 si restas el contenido del carro)"਍∀嬀攀渀最氀椀猀栀崀匀琀漀爀攀开圀愀氀氀攀琀∀ऀ∀匀琀攀愀洀 䄀挀挀漀甀渀琀 䈀愀氀愀渀挀攀㨀 ␀─猀㄀  ⠀␀─猀㈀ 氀攀昀琀 愀昀琀攀爀 挀愀爀琀⤀∀ഀഀ
"Store_Wallet_EmptyCart"	"Saldo de tu cuenta de Steam: $%s1"਍∀嬀攀渀最氀椀猀栀崀匀琀漀爀攀开圀愀氀氀攀琀开䔀洀瀀琀礀䌀愀爀琀∀ऀ∀匀琀攀愀洀 䄀挀挀漀甀渀琀 䈀愀氀愀渀挀攀㨀 ␀─猀㄀∀ഀഀ
"Store_FeaturedItem"	"¡Destacado!"਍∀嬀攀渀最氀椀猀栀崀匀琀漀爀攀开䘀攀愀琀甀爀攀搀䤀琀攀洀∀ऀ∀䘀攀愀琀甀爀攀搀 椀琀攀洀℀∀ഀഀ
"Store_PreviewItem"	"Vista previa"਍∀嬀攀渀最氀椀猀栀崀匀琀漀爀攀开倀爀攀瘀椀攀眀䤀琀攀洀∀ऀ∀倀爀攀瘀椀攀眀∀ഀഀ
"Store_DetailsItem"	"Detalles"਍∀嬀攀渀最氀椀猀栀崀匀琀漀爀攀开䐀攀琀愀椀氀猀䤀琀攀洀∀ऀ∀䐀攀琀愀椀氀猀∀ഀഀ
"Store_FreeBackpackSpace"	"Ranuras vacías en mochila: %s1"਍∀嬀攀渀最氀椀猀栀崀匀琀漀爀攀开䘀爀攀攀䈀愀挀欀瀀愀挀欀匀瀀愀挀攀∀ऀ∀䔀洀瀀琀礀 䈀愀挀欀瀀愀挀欀 匀氀漀琀猀㨀 ─猀㄀∀ഀഀ
"StoreCheckout_NoItems"	"¡Tu carrito de compras está vacío!"਍∀嬀攀渀最氀椀猀栀崀匀琀漀爀攀䌀栀攀挀欀漀甀琀开一漀䤀琀攀洀猀∀ऀ∀夀漀甀爀 猀栀漀瀀瀀椀渀最 挀愀爀琀 椀猀 攀洀瀀琀礀℀∀ഀഀ
"StoreCheckout_TooManyItems"	"¡Tienes demasiados objetos en tu carro de la compra!"਍∀嬀攀渀最氀椀猀栀崀匀琀漀爀攀䌀栀攀挀欀漀甀琀开吀漀漀䴀愀渀礀䤀琀攀洀猀∀ऀ∀夀漀甀 栀愀瘀攀 琀漀漀 洀愀渀礀 椀琀攀洀猀 椀渀 礀漀甀爀 猀栀漀瀀瀀椀渀最 挀愀爀琀℀∀ഀഀ
"StoreCheckout_Loading"	"Procediendo al pago..."਍∀嬀攀渀最氀椀猀栀崀匀琀漀爀攀䌀栀攀挀欀漀甀琀开䰀漀愀搀椀渀最∀ऀ∀䌀栀攀挀欀椀渀最 漀甀琀⸀⸀⸀∀ഀഀ
"StoreCheckout_Unavailable"	"El procedimiento de pago no está disponible en este momento."਍∀嬀攀渀最氀椀猀栀崀匀琀漀爀攀䌀栀攀挀欀漀甀琀开唀渀愀瘀愀椀氀愀戀氀攀∀ऀ∀䌀栀攀挀欀漀甀琀 甀渀愀瘀愀椀氀愀戀氀攀 愀琀 琀栀椀猀 琀椀洀攀⸀∀ഀഀ
"StoreCheckout_Canceling"	"Cancelando..."਍∀嬀攀渀最氀椀猀栀崀匀琀漀爀攀䌀栀攀挀欀漀甀琀开䌀愀渀挀攀氀椀渀最∀ऀ∀䌀愀渀挀攀氀椀渀最⸀⸀⸀∀ഀഀ
"StoreUpdate_Loading"	"Cargando la tienda..."਍∀嬀攀渀最氀椀猀栀崀匀琀漀爀攀唀瀀搀愀琀攀开䰀漀愀搀椀渀最∀ऀ∀䰀漀愀搀椀渀最 琀栀攀 匀琀漀爀攀⸀⸀⸀∀ഀഀ
"StoreUpdate_NoGCResponse"	"La tienda está cerrada en este momento."਍∀嬀攀渀最氀椀猀栀崀匀琀漀爀攀唀瀀搀愀琀攀开一漀䜀䌀刀攀猀瀀漀渀猀攀∀ऀ∀吀栀攀 匀琀漀爀攀 椀猀 挀甀爀爀攀渀琀氀礀 挀氀漀猀攀搀⸀∀ഀഀ
"StoreUpdate_NewPriceSheetLoaded"	"La lista de productos se ha actualizado con la versión más reciente."਍∀嬀攀渀最氀椀猀栀崀匀琀漀爀攀唀瀀搀愀琀攀开一攀眀倀爀椀挀攀匀栀攀攀琀䰀漀愀搀攀搀∀ऀ∀吀栀攀 瀀爀漀搀甀挀琀 氀椀猀琀 栀愀猀 戀攀攀渀 甀瀀搀愀琀攀搀 琀漀 琀栀攀 氀愀琀攀猀琀 瘀攀爀猀椀漀渀⸀∀ഀഀ
"StoreUpdate_ContactSupport"	"Ponte en contacto con el servicio de asistencia al cliente para configurar tu cartera de Steam."਍∀嬀攀渀最氀椀猀栀崀匀琀漀爀攀唀瀀搀愀琀攀开䌀漀渀琀愀挀琀匀甀瀀瀀漀爀琀∀ऀ∀倀氀攀愀猀攀 挀漀渀琀愀挀琀 挀甀猀琀漀洀攀爀 猀甀瀀瀀漀爀琀 琀漀 栀愀瘀攀 礀漀甀爀 匀琀攀愀洀 眀愀氀氀攀琀 挀漀渀昀椀最甀爀攀搀⸀∀ഀഀ
"StoreUpdate_OverlayRequired"	"Debes activar la Comunidad Steam en la partida y reiniciar para usar la tienda."਍∀嬀攀渀最氀椀猀栀崀匀琀漀爀攀唀瀀搀愀琀攀开伀瘀攀爀氀愀礀刀攀焀甀椀爀攀搀∀ऀ∀夀漀甀 洀甀猀琀 攀渀愀戀氀攀 琀栀攀 匀琀攀愀洀 䌀漀洀洀甀渀椀琀礀 椀渀ⴀ最愀洀攀 愀渀搀 爀攀猀琀愀爀琀 琀栀攀 最愀洀攀 琀漀 甀猀攀 琀栀攀 匀琀漀爀攀⸀∀ഀഀ
"StoreUpdate_SteamRequired"	"Es necesario estar conectado a Steam para usar la tienda."਍∀嬀攀渀最氀椀猀栀崀匀琀漀爀攀唀瀀搀愀琀攀开匀琀攀愀洀刀攀焀甀椀爀攀搀∀ऀ∀䄀 挀漀渀渀攀挀琀椀漀渀 琀漀 匀琀攀愀洀 椀猀 爀攀焀甀椀爀攀搀 琀漀 甀猀攀 琀栀攀 匀琀漀爀攀⸀∀ഀഀ
"StoreCheckout_Fail"	"La tienda está cerrada en este momento."਍∀嬀攀渀最氀椀猀栀崀匀琀漀爀攀䌀栀攀挀欀漀甀琀开䘀愀椀氀∀ऀ∀吀栀攀 䤀渀ⴀ最愀洀攀 匀琀漀爀攀 椀猀 挀甀爀爀攀渀琀氀礀 挀氀漀猀攀搀⸀∀ഀഀ
"StoreCheckout_InvalidParam"	"¡Un programador la ha liado! Se ha transmitido un parámetro no válido al coordinador del juego. Vuelve a intentar la compra."਍∀嬀攀渀最氀椀猀栀崀匀琀漀爀攀䌀栀攀挀欀漀甀琀开䤀渀瘀愀氀椀搀倀愀爀愀洀∀ऀ∀䄀 瀀爀漀最爀愀洀洀攀爀 洀攀猀猀攀搀 甀瀀℀ 䄀渀 椀渀瘀愀氀椀搀 瀀愀爀愀洀攀琀攀爀 眀愀猀 瀀愀猀猀攀搀 琀漀 琀栀攀 最愀洀攀 挀漀漀爀搀椀渀愀琀漀爀⸀ 吀爀礀 琀栀攀 瀀甀爀挀栀愀猀攀 愀最愀椀渀⸀∀ഀഀ
"StoreCheckout_InternalError"	"Parece que se ha producido un error al inicializar o actualizar tu transacción. Por favor, vuelve a intentarlo pasado un minuto o ponte en contacto con el servicio de asistencia."਍∀嬀攀渀最氀椀猀栀崀匀琀漀爀攀䌀栀攀挀欀漀甀琀开䤀渀琀攀爀渀愀氀䔀爀爀漀爀∀ऀ∀吀栀攀爀攀 猀攀攀洀猀 琀漀 栀愀瘀攀 戀攀攀渀 愀渀 攀爀爀漀爀 椀渀椀琀椀愀氀椀稀椀渀最 漀爀 甀瀀搀愀琀椀渀最 礀漀甀爀 琀爀愀渀猀愀挀琀椀漀渀⸀ 倀氀攀愀猀攀 眀愀椀琀 愀 洀椀渀甀琀攀 愀渀搀 琀爀礀 愀最愀椀渀 漀爀 挀漀渀琀愀挀琀 猀甀瀀瀀漀爀琀 昀漀爀 愀猀猀椀猀琀愀渀挀攀⸀∀ഀഀ
"StoreCheckout_ContactSupport"	"Se ha producido un error con tu transacción. Por favor, ponte en contacto con el soporte técnico para recibir ayuda."਍∀嬀攀渀最氀椀猀栀崀匀琀漀爀攀䌀栀攀挀欀漀甀琀开䌀漀渀琀愀挀琀匀甀瀀瀀漀爀琀∀ऀ∀吀栀攀爀攀 眀愀猀 愀渀 攀爀爀漀爀 眀椀琀栀 礀漀甀爀 琀爀愀渀猀愀挀琀椀漀渀⸀ 倀氀攀愀猀攀 挀漀渀琀愀挀琀 猀甀瀀瀀漀爀琀 昀漀爀 愀猀猀椀猀琀愀渀挀攀⸀∀ഀഀ
"StoreCheckout_NotApproved"	"El coordinador del juego no ha podido aprobar tu transacción en Steam. Vuelve a intentar la compra más tarde."਍∀嬀攀渀最氀椀猀栀崀匀琀漀爀攀䌀栀攀挀欀漀甀琀开一漀琀䄀瀀瀀爀漀瘀攀搀∀ऀ∀吀栀攀 最愀洀攀 挀漀漀爀搀椀渀愀琀漀爀 眀愀猀 甀渀愀戀氀攀 琀漀 愀瀀瀀爀漀瘀攀 礀漀甀爀 琀爀愀渀猀愀挀琀椀漀渀 眀椀琀栀 匀琀攀愀洀⸀ 倀氀攀愀猀攀 琀爀礀 琀栀攀 瀀甀爀挀栀愀猀攀 愀最愀椀渀 氀愀琀攀爀⸀∀ഀഀ
"StoreCheckout_NotLoggedin"	"Para poder realizar una compra debes iniciar sesión en Steam."਍∀嬀攀渀最氀椀猀栀崀匀琀漀爀攀䌀栀攀挀欀漀甀琀开一漀琀䰀漀最最攀搀椀渀∀ऀ∀夀漀甀 洀甀猀琀 戀攀 氀漀最最攀搀 椀渀 琀漀 匀琀攀愀洀 椀渀 漀爀搀攀爀 琀漀 挀漀洀瀀氀攀琀攀 愀 瀀甀爀挀栀愀猀攀⸀∀ഀഀ
"StoreCheckout_WrongCurrency"	"La moneda de esta transacción no se corresponde con la moneda de tu cartera."਍∀嬀攀渀最氀椀猀栀崀匀琀漀爀攀䌀栀攀挀欀漀甀琀开圀爀漀渀最䌀甀爀爀攀渀挀礀∀ऀ∀吀栀椀猀 琀爀愀渀猀愀挀琀椀漀渀✀猀 挀甀爀爀攀渀挀礀 搀漀攀猀渀✀琀 洀愀琀挀栀 礀漀甀爀 眀愀氀氀攀琀 挀甀爀爀攀渀挀礀⸀∀ഀഀ
"StoreCheckout_NoAccount"	"Tu cuenta de Steam no está disponible en este momento. Vuelve a intentar la compra más tarde."਍∀嬀攀渀最氀椀猀栀崀匀琀漀爀攀䌀栀攀挀欀漀甀琀开一漀䄀挀挀漀甀渀琀∀ऀ∀夀漀甀爀 匀琀攀愀洀 愀挀挀漀甀渀琀 椀猀 挀甀爀爀攀渀琀氀礀 甀渀愀瘀愀椀氀愀戀氀攀⸀ 倀氀攀愀猀攀 琀爀礀 琀栀椀猀 瀀甀爀挀栀愀猀攀 愀最愀椀渀 氀愀琀攀爀⸀∀ഀഀ
"StoreCheckout_InsufficientFunds"	"No tienes suficientes fondos para completar la compra."਍∀嬀攀渀最氀椀猀栀崀匀琀漀爀攀䌀栀攀挀欀漀甀琀开䤀渀猀甀昀昀椀挀椀攀渀琀䘀甀渀搀猀∀ऀ∀夀漀甀 搀漀 渀漀琀 栀愀瘀攀 攀渀漀甀最栀 昀甀渀搀猀 琀漀 挀漀洀瀀氀攀琀攀 琀栀攀 瀀甀爀挀栀愀猀攀⸀∀ഀഀ
"StoreCheckout_TimedOut"	"Esta transacción ha superado el tiempo límite de conexión. Vuelve a intentar la compra más tarde."਍∀嬀攀渀最氀椀猀栀崀匀琀漀爀攀䌀栀攀挀欀漀甀琀开吀椀洀攀搀伀甀琀∀ऀ∀吀栀椀猀 琀爀愀渀猀愀挀琀椀漀渀 栀愀猀 琀椀洀攀搀 漀甀琀⸀ 倀氀攀愀猀攀 琀爀礀 琀栀攀 瀀甀爀挀栀愀猀攀 愀最愀椀渀⸀∀ഀഀ
"StoreCheckout_SteamAccountDisabled"	"Tu cuenta de Steam está desactivada. No puedes realizar una compra."਍∀嬀攀渀最氀椀猀栀崀匀琀漀爀攀䌀栀攀挀欀漀甀琀开匀琀攀愀洀䄀挀挀漀甀渀琀䐀椀猀愀戀氀攀搀∀ऀ∀夀漀甀爀 匀琀攀愀洀 愀挀挀漀甀渀琀 椀猀 搀椀猀愀戀氀攀搀 愀渀搀 挀愀渀渀漀琀 洀愀欀攀 愀 瀀甀爀挀栀愀猀攀⸀∀ഀഀ
"StoreCheckout_SteamAccountNoPurchase"	"Las transacciones con la Cartera de Steam se han desactivado en esta cuenta."਍∀嬀攀渀最氀椀猀栀崀匀琀漀爀攀䌀栀攀挀欀漀甀琀开匀琀攀愀洀䄀挀挀漀甀渀琀一漀倀甀爀挀栀愀猀攀∀ऀ∀匀琀攀愀洀 眀愀氀氀攀琀 琀爀愀渀猀愀挀琀椀漀渀猀 栀愀瘀攀 戀攀攀渀 搀椀猀愀戀氀攀搀 漀渀 琀栀椀猀 愀挀挀漀甀渀琀⸀∀ഀഀ
"StoreCheckout_OldPriceSheet"	"Tu lista local de productos está obsoleta. Solicitando una nueva."਍∀嬀攀渀最氀椀猀栀崀匀琀漀爀攀䌀栀攀挀欀漀甀琀开伀氀搀倀爀椀挀攀匀栀攀攀琀∀ऀ∀夀漀甀爀 氀漀挀愀氀 瀀爀漀搀甀挀琀 氀椀猀琀 椀猀 漀甀琀 漀昀 搀愀琀攀⸀ 刀攀焀甀攀猀琀椀渀最 愀 渀攀眀 漀渀攀⸀∀ഀഀ
"StoreCheckout_TransactionNotFound"	"El coordinador del juego no ha podido encontrar la identificación de esta transacción. Por favor, vuelve a intentar la compra más tarde."਍∀嬀攀渀最氀椀猀栀崀匀琀漀爀攀䌀栀攀挀欀漀甀琀开吀爀愀渀猀愀挀琀椀漀渀一漀琀䘀漀甀渀搀∀ऀ∀吀栀椀猀 琀爀愀渀猀愀挀琀椀漀渀✀猀 椀搀 眀愀猀渀✀琀 昀漀甀渀搀 戀礀 琀栀攀 最愀洀攀 挀漀漀爀搀椀渀愀琀漀爀⸀ 倀氀攀愀猀攀 琀爀礀 琀栀攀 瀀甀爀挀栀愀猀攀 愀最愀椀渀⸀∀ഀഀ
"StoreCheckout_TransactionCanceled"	"Se ha cancelado la transacción. No has recibido cargo alguno."਍∀嬀攀渀最氀椀猀栀崀匀琀漀爀攀䌀栀攀挀欀漀甀琀开吀爀愀渀猀愀挀琀椀漀渀䌀愀渀挀攀氀攀搀∀ऀ∀吀爀愀渀猀愀挀琀椀漀渀 挀愀渀挀攀氀攀搀⸀ 夀漀甀 栀愀瘀攀 渀漀琀 戀攀攀渀 挀栀愀爀最攀搀⸀∀ഀഀ
"StoreCheckout_TransactionCompleted"	"Se ha completado la transacción. ¡Disfruta de tu botín!"਍∀嬀攀渀最氀椀猀栀崀匀琀漀爀攀䌀栀攀挀欀漀甀琀开吀爀愀渀猀愀挀琀椀漀渀䌀漀洀瀀氀攀琀攀搀∀ऀ∀吀爀愀渀猀愀挀琀椀漀渀 挀漀洀瀀氀攀琀攀搀℀ 䔀渀樀漀礀 礀漀甀爀 氀漀漀琀℀∀ഀഀ
"StoreCheckout_CompleteButUnfinalized"	"No se ha podido confirmar que la transacción se haya realizado correctamente. Si ha sido así, tus objetos se entregarán más adelante."਍∀嬀攀渀最氀椀猀栀崀匀琀漀爀攀䌀栀攀挀欀漀甀琀开䌀漀洀瀀氀攀琀攀䈀甀琀唀渀昀椀渀愀氀椀稀攀搀∀ऀ∀唀渀愀戀氀攀 琀漀 挀漀渀昀椀爀洀 猀甀挀挀攀猀猀⸀ 䤀昀 猀甀挀挀攀猀猀昀甀氀Ⰰ 礀漀甀爀 椀琀攀洀猀 眀椀氀氀 戀攀 搀攀氀椀瘀攀爀攀搀 愀琀 愀 氀愀琀攀爀 搀愀琀攀⸀∀ഀഀ
"StoreCheckout_NotEnoughRoom"	"No tienes espacio en tu mochila para comprar tantos objetos."਍∀嬀攀渀最氀椀猀栀崀匀琀漀爀攀䌀栀攀挀欀漀甀琀开一漀琀䔀渀漀甀最栀刀漀漀洀∀ऀ∀夀漀甀 搀漀渀✀琀 栀愀瘀攀 攀渀漀甀最栀 爀漀漀洀 椀渀 礀漀甀爀 戀愀挀欀瀀愀挀欀 琀漀 戀甀礀 琀栀愀琀 洀愀渀礀 椀琀攀洀猀⸀∀ഀഀ
"StoreCheckout_ContactSupport_Dialog_Title"	"Aviso"਍∀嬀攀渀最氀椀猀栀崀匀琀漀爀攀䌀栀攀挀欀漀甀琀开䌀漀渀琀愀挀琀匀甀瀀瀀漀爀琀开䐀椀愀氀漀最开吀椀琀氀攀∀ऀ∀圀愀爀渀椀渀最∀ഀഀ
"StoreCheckout_ContactSupport_Dialog_Btn"	"Contactar"਍∀嬀攀渀最氀椀猀栀崀匀琀漀爀攀䌀栀攀挀欀漀甀琀开䌀漀渀琀愀挀琀匀甀瀀瀀漀爀琀开䐀椀愀氀漀最开䈀琀渀∀ऀ∀䌀漀渀琀愀挀琀∀ഀഀ
"Econ_Back"	"Atrás"਍∀嬀攀渀最氀椀猀栀崀䔀挀漀渀开䈀愀挀欀∀ऀ∀䈀愀挀欀∀ഀഀ
"BackpackTitle"	"MOCHILA"਍∀嬀攀渀最氀椀猀栀崀䈀愀挀欀瀀愀挀欀吀椀琀氀攀∀ऀ∀䈀䄀䌀䬀倀䄀䌀䬀∀ഀഀ
"X_DeleteItem"	"X BORRAR"਍∀嬀攀渀最氀椀猀栀崀堀开䐀攀氀攀琀攀䤀琀攀洀∀ऀ∀堀 䐀䔀䰀䔀吀䔀∀ഀഀ
"X_Delete"	"X BORRAR"਍∀嬀攀渀最氀椀猀栀崀堀开䐀攀氀攀琀攀∀ऀ∀堀 䐀䔀䰀䔀吀䔀∀ഀഀ
"X_DiscardItem"	"X DESCARTAR"਍∀嬀攀渀最氀椀猀栀崀堀开䐀椀猀挀愀爀搀䤀琀攀洀∀ऀ∀堀 䐀䤀匀䌀䄀刀䐀∀ഀഀ
"DiscardItem"	"Descartar permanentemente"਍∀嬀攀渀最氀椀猀栀崀䐀椀猀挀愀爀搀䤀琀攀洀∀ऀ∀倀攀爀洀愀渀攀渀琀氀礀 䐀椀猀挀愀爀搀∀ഀഀ
"DeleteConfirmTitle"	"¿ESTÁS SEGURO?"਍∀嬀攀渀最氀椀猀栀崀䐀攀氀攀琀攀䌀漀渀昀椀爀洀吀椀琀氀攀∀ऀ∀䄀刀䔀 夀伀唀 匀唀刀䔀㼀∀ഀഀ
"ConfirmTitle"	"¿ESTÁS SEGURO?"਍∀嬀攀渀最氀椀猀栀崀䌀漀渀昀椀爀洀吀椀琀氀攀∀ऀ∀䄀刀䔀 夀伀唀 匀唀刀䔀㼀∀ഀഀ
"ConfirmButtonText"	"CONTINUAR"਍∀嬀攀渀最氀椀猀栀崀䌀漀渀昀椀爀洀䈀甀琀琀漀渀吀攀砀琀∀ऀ∀䌀伀一吀䤀一唀䔀∀ഀഀ
"DeleteItemConfirmText"	"Si borras este objeto lo destruirás permanentemente. Esta acción no se puede deshacer."਍∀嬀攀渀最氀椀猀栀崀䐀攀氀攀琀攀䤀琀攀洀䌀漀渀昀椀爀洀吀攀砀琀∀ऀ∀䐀攀氀攀琀椀渀最 琀栀椀猀 椀琀攀洀 眀椀氀氀 瀀攀爀洀愀渀攀渀琀氀礀 搀攀猀琀爀漀礀 椀琀⸀ 吀栀椀猀 挀愀渀渀漀琀 戀攀 甀渀搀漀渀攀⸀∀ഀഀ
"MultiDeleteItemConfirmText"	"Borrar estos objetos los destruirá permanentemente. Esta acción no se puede deshacer."਍∀嬀攀渀最氀椀猀栀崀䴀甀氀琀椀䐀攀氀攀琀攀䤀琀攀洀䌀漀渀昀椀爀洀吀攀砀琀∀ऀ∀䐀攀氀攀琀椀渀最 琀栀攀猀攀 椀琀攀洀猀 眀椀氀氀 瀀攀爀洀愀渀攀渀琀氀礀 搀攀猀琀爀漀礀 愀氀氀 漀昀 琀栀攀洀⸀ 吀栀椀猀 挀愀渀渀漀琀 戀攀 甀渀搀漀渀攀⸀∀ഀഀ
"X_DeleteConfirmButton"	"X SÍ, BÓRRALO"਍∀嬀攀渀最氀椀猀栀崀堀开䐀攀氀攀琀攀䌀漀渀昀椀爀洀䈀甀琀琀漀渀∀ऀ∀堀 夀䔀䄀䠀Ⰰ 䐀䔀䰀䔀吀䔀 䤀吀∀ഀഀ
"Backpack_Delete_Item"	"MOCHILA - SIN ESPACIO"਍∀嬀攀渀最氀椀猀栀崀䈀愀挀欀瀀愀挀欀开䐀攀氀攀琀攀开䤀琀攀洀∀ऀ∀䈀䄀䌀䬀倀䄀䌀䬀 ⴀ 伀唀吀 伀䘀 刀伀伀䴀∀ഀഀ
"DiscardExplanation"	"Has recogido este objeto, pero no queda sitio para él en tu mochila."਍∀嬀攀渀最氀椀猀栀崀䐀椀猀挀愀爀搀䔀砀瀀氀愀渀愀琀椀漀渀∀ऀ∀夀漀甀✀瘀攀 爀攀挀攀椀瘀攀搀 琀栀椀猀 椀琀攀洀Ⰰ 戀甀琀 礀漀甀 搀漀渀✀琀 栀愀瘀攀 爀漀漀洀 昀漀爀 椀琀 椀渀 礀漀甀爀 戀愀挀欀瀀愀挀欀⸀∀ഀഀ
"DiscardExplanation2"	"Borra uno de los siguientes objetos para hacer sitio o descarta el nuevo objeto."਍∀嬀攀渀最氀椀猀栀崀䐀椀猀挀愀爀搀䔀砀瀀氀愀渀愀琀椀漀渀㈀∀ऀ∀䐀攀氀攀琀攀 愀渀 椀琀攀洀 戀攀氀漀眀 琀漀 洀愀欀攀 爀漀漀洀 漀爀 瀀爀攀猀猀 搀椀猀挀愀爀搀 琀漀 琀栀爀漀眀 礀漀甀爀 渀攀眀 椀琀攀洀 愀眀愀礀⸀∀ഀഀ
"DeleteConfirmDefault"	"¿Borrar?"਍∀嬀攀渀最氀椀猀栀崀䐀攀氀攀琀攀䌀漀渀昀椀爀洀䐀攀昀愀甀氀琀∀ऀ∀䐀攀氀攀琀攀㼀∀ഀഀ
"Discarded"	"¡DESCARTADO!"਍∀嬀攀渀最氀椀猀栀崀䐀椀猀挀愀爀搀攀搀∀ऀ∀䐀䤀匀䌀䄀刀䐀䔀䐀℀∀ഀഀ
"ItemPanelEquipped"	"Equipado"਍∀嬀攀渀最氀椀猀栀崀䤀琀攀洀倀愀渀攀氀䔀焀甀椀瀀瀀攀搀∀ऀ∀䔀焀甀椀瀀瀀攀搀∀ഀഀ
"BackpackApplyTool"	"Selecciona a qué objeto aplicar %s1:"਍∀嬀攀渀最氀椀猀栀崀䈀愀挀欀瀀愀挀欀䄀瀀瀀氀礀吀漀漀氀∀ऀ∀匀攀氀攀挀琀 琀栀攀 椀琀攀洀 琀漀 愀瀀瀀氀礀 琀栀攀 ─猀㄀ 琀漀㨀∀ഀഀ
"ApplyOnItem"	"USAR CON..."਍∀嬀攀渀最氀椀猀栀崀䄀瀀瀀氀礀伀渀䤀琀攀洀∀ऀ∀唀匀䔀 圀䤀吀䠀⸀⸀⸀∀ഀഀ
"ConsumeItem"	"USAR"਍∀嬀攀渀最氀椀猀栀崀䌀漀渀猀甀洀攀䤀琀攀洀∀ऀ∀唀匀䔀∀ഀഀ
"RefurbishItem"	"RESTAURAR"਍∀嬀攀渀最氀椀猀栀崀刀攀昀甀爀戀椀猀栀䤀琀攀洀∀ऀ∀刀䔀匀吀伀刀䔀∀ഀഀ
"CustomizeItem"	"PERSONALIZAR"਍∀嬀攀渀最氀椀猀栀崀䌀甀猀琀漀洀椀稀攀䤀琀攀洀∀ऀ∀䌀唀匀吀伀䴀䤀娀䔀∀ഀഀ
"ShowBaseItems"	"OBJETOS BÁSICOS"਍∀嬀攀渀最氀椀猀栀崀匀栀漀眀䈀愀猀攀䤀琀攀洀猀∀ऀ∀匀吀伀䌀䬀 䤀吀䔀䴀匀∀ഀഀ
"ShowBackpackItems"	"OBJETOS ESPECIALES"਍∀嬀攀渀最氀椀猀栀崀匀栀漀眀䈀愀挀欀瀀愀挀欀䤀琀攀洀猀∀ऀ∀匀倀䔀䌀䤀䄀䰀 䤀吀䔀䴀匀∀ഀഀ
"ShowBaseItemsCheckBox"	"Mostrar objetos básicos"਍∀嬀攀渀最氀椀猀栀崀匀栀漀眀䈀愀猀攀䤀琀攀洀猀䌀栀攀挀欀䈀漀砀∀ऀ∀匀栀漀眀 匀琀漀挀欀 䤀琀攀洀猀∀ഀഀ
"ShowDuplicateItemsCheckbox"	"Mostrar objetos duplicados"਍∀嬀攀渀最氀椀猀栀崀匀栀漀眀䐀甀瀀氀椀挀愀琀攀䤀琀攀洀猀䌀栀攀挀欀戀漀砀∀ऀ∀匀栀漀眀 䐀甀瀀氀椀挀愀琀攀 䤀琀攀洀猀∀ഀഀ
"WrapGift"	"ENVOLVER REGALO"਍∀嬀攀渀最氀椀猀栀崀圀爀愀瀀䜀椀昀琀∀ऀ∀圀刀䄀倀 䜀䤀䘀吀∀ഀഀ
"UnwrapGift"	"DESENVOLVER REGALO"਍∀嬀攀渀最氀椀猀栀崀唀渀眀爀愀瀀䜀椀昀琀∀ऀ∀唀一圀刀䄀倀 䜀䤀䘀吀∀ഀഀ
"DeliverGift"	"ENTREGAR REGALO"਍∀嬀攀渀最氀椀猀栀崀䐀攀氀椀瘀攀爀䜀椀昀琀∀ऀ∀䐀䔀䰀䤀嘀䔀刀 䜀䤀䘀吀∀ഀഀ
"NoAction"	"SIN ACCIÓN"਍∀嬀攀渀最氀椀猀栀崀一漀䄀挀琀椀漀渀∀ऀ∀一伀 䄀䌀吀䤀伀一∀ഀഀ
"Style"	"CONFIGURAR ESTILO"਍∀嬀攀渀最氀椀猀栀崀匀琀礀氀攀∀ऀ∀匀䔀吀 匀吀夀䰀䔀∀ഀഀ
"TF_Item_SelectStyle"	"ESCOGER ESTILO"਍∀嬀攀渀最氀椀猀栀崀吀䘀开䤀琀攀洀开匀攀氀攀挀琀匀琀礀氀攀∀ऀ∀匀䔀䰀䔀䌀吀 匀吀夀䰀䔀∀ഀഀ
"RefurbishItem_RemovePaintTitle"	"¿Quitar pintura?"਍∀嬀攀渀最氀椀猀栀崀刀攀昀甀爀戀椀猀栀䤀琀攀洀开刀攀洀漀瘀攀倀愀椀渀琀吀椀琀氀攀∀ऀ∀刀攀洀漀瘀攀 倀愀椀渀琀㼀∀ഀഀ
"RefurbishItem_RemovePaint"	"¿Quieres quitar el color personalizado de este objeto, restableciendo así el suyo original?\n\n(La Pintura será desechada)"਍∀嬀攀渀最氀椀猀栀崀刀攀昀甀爀戀椀猀栀䤀琀攀洀开刀攀洀漀瘀攀倀愀椀渀琀∀ऀ∀刀攀洀漀瘀攀 琀栀攀 挀甀猀琀漀洀 挀漀氀漀爀 昀爀漀洀 琀栀椀猀 椀琀攀洀Ⰰ 爀攀猀琀漀爀椀渀最 椀琀猀 漀爀椀最椀渀愀氀 挀漀氀漀爀㼀尀渀尀渀⠀倀愀椀渀琀 眀椀氀氀 戀攀 搀椀猀挀愀爀搀攀搀⤀∀ഀഀ
"RefurbishItem_RemoveNameTitle"	"¿Quitar nombre?"਍∀嬀攀渀最氀椀猀栀崀刀攀昀甀爀戀椀猀栀䤀琀攀洀开刀攀洀漀瘀攀一愀洀攀吀椀琀氀攀∀ऀ∀刀攀洀漀瘀攀 一愀洀攀㼀∀ഀഀ
"RefurbishItem_RemoveName"	"¿Quieres quitar el nombre personalizado de este objeto, restableciendo así el suyo original?\n\n(La Etiqueta de Nombre será desechada)"਍∀嬀攀渀最氀椀猀栀崀刀攀昀甀爀戀椀猀栀䤀琀攀洀开刀攀洀漀瘀攀一愀洀攀∀ऀ∀刀攀洀漀瘀攀 琀栀攀 挀甀猀琀漀洀 渀愀洀攀 昀爀漀洀 琀栀椀猀 椀琀攀洀Ⰰ 爀攀猀琀漀爀椀渀最 椀琀猀 漀爀椀最椀渀愀氀 渀愀洀攀㼀尀渀尀渀⠀一愀洀攀 吀愀最 眀椀氀氀 戀攀 搀椀猀挀愀爀搀攀搀⤀∀ഀഀ
"RefurbishItem_RemoveDescTitle"	"¿Quitar descripción?"਍∀嬀攀渀最氀椀猀栀崀刀攀昀甀爀戀椀猀栀䤀琀攀洀开刀攀洀漀瘀攀䐀攀猀挀吀椀琀氀攀∀ऀ∀刀攀洀漀瘀攀 䐀攀猀挀㼀∀ഀഀ
"RefurbishItem_RemoveDesc"	"¿Quieres quitar la descripción de este objeto, restableciendo así la suya original?\n\n(La Etiqueta de Descripción será desechada)"਍∀嬀攀渀最氀椀猀栀崀刀攀昀甀爀戀椀猀栀䤀琀攀洀开刀攀洀漀瘀攀䐀攀猀挀∀ऀ∀刀攀洀漀瘀攀 琀栀攀 搀攀猀挀爀椀瀀琀椀漀渀 昀爀漀洀 琀栀椀猀 椀琀攀洀Ⰰ 爀攀猀琀漀爀椀渀最 椀琀猀 漀爀椀最椀渀愀氀 搀攀猀挀爀椀瀀琀椀漀渀㼀尀渀尀渀⠀䐀攀猀挀爀椀瀀琀椀漀渀 吀愀最 眀椀氀氀 戀攀 搀椀猀挀愀爀搀攀搀⤀∀ഀഀ
"RefurbishItem_Yes"	"Sí, bórralo"਍∀嬀攀渀最氀椀猀栀崀刀攀昀甀爀戀椀猀栀䤀琀攀洀开夀攀猀∀ऀ∀夀攀猀Ⰰ 圀椀瀀攀 䤀琀∀ഀഀ
"RefurbishItem_No"	"No, déjalo"਍∀嬀攀渀最氀椀猀栀崀刀攀昀甀爀戀椀猀栀䤀琀攀洀开一漀∀ऀ∀一漀Ⰰ 䰀攀愀瘀攀 䤀琀∀ഀഀ
"ToolConfirmWarning"	"Recuerda: una vez que hayas usado una herramienta, la perderás."਍∀嬀攀渀最氀椀猀栀崀吀漀漀氀䌀漀渀昀椀爀洀圀愀爀渀椀渀最∀ऀ∀刀攀洀攀洀戀攀爀Ⰰ 漀渀挀攀 礀漀甀 栀愀瘀攀 甀猀攀搀 愀 琀漀漀氀Ⰰ 椀琀✀猀 最漀渀攀℀∀ഀഀ
"ToolItemRenameOldItemName"	"Nombre actual:"਍∀嬀攀渀最氀椀猀栀崀吀漀漀氀䤀琀攀洀刀攀渀愀洀攀伀氀搀䤀琀攀洀一愀洀攀∀ऀ∀䌀甀爀爀攀渀琀 䤀琀攀洀 一愀洀攀㨀∀ഀഀ
"ToolItemRenameNewItemName"	"Nuevo nombre:"਍∀嬀攀渀最氀椀猀栀崀吀漀漀氀䤀琀攀洀刀攀渀愀洀攀一攀眀䤀琀攀洀一愀洀攀∀ऀ∀一攀眀 䤀琀攀洀 一愀洀攀㨀∀ഀഀ
"ToolItemRenameOldItemDesc"	"Desc. actual del objeto:"਍∀嬀攀渀最氀椀猀栀崀吀漀漀氀䤀琀攀洀刀攀渀愀洀攀伀氀搀䤀琀攀洀䐀攀猀挀∀ऀ∀䌀甀爀爀攀渀琀 䤀琀攀洀 䐀攀猀挀㨀∀ഀഀ
"ToolItemRenameNewItemDesc"	"Desc. nueva del objeto:"਍∀嬀攀渀最氀椀猀栀崀吀漀漀氀䤀琀攀洀刀攀渀愀洀攀一攀眀䤀琀攀洀䐀攀猀挀∀ऀ∀一攀眀 䤀琀攀洀 䐀攀猀挀㨀∀ഀഀ
"ToolDialogTitle"	"Usando %s1 en %s2"਍∀嬀攀渀最氀椀猀栀崀吀漀漀氀䐀椀愀氀漀最吀椀琀氀攀∀ऀ∀Ā唀猀椀渀最 Ȁ─猀㄀Ā 漀渀 ̀─猀㈀∀ഀഀ
"CraftAskName"	"Escribe el nuevo nombre de este objeto:"਍∀嬀攀渀最氀椀猀栀崀䌀爀愀昀琀䄀猀欀一愀洀攀∀ऀ∀䔀渀琀攀爀 琀栀椀猀 䤀琀攀洀✀猀 一攀眀 一愀洀攀㨀∀ഀഀ
"CraftNameOk"	"¡Dale un nombre!"਍∀嬀攀渀最氀椀猀栀崀䌀爀愀昀琀一愀洀攀伀欀∀ऀ∀一愀洀攀 䤀琀℀∀ഀഀ
"CraftDescribeOk"	"¡Descríbelo!"਍∀嬀攀渀最氀椀猀栀崀䌀爀愀昀琀䐀攀猀挀爀椀戀攀伀欀∀ऀ∀䐀攀猀挀爀椀戀攀 䤀琀℀∀ഀഀ
"CraftNameCancel"	"No, gracias."਍∀嬀攀渀最氀椀猀栀崀䌀爀愀昀琀一愀洀攀䌀愀渀挀攀氀∀ऀ∀一漀 吀栀愀渀欀猀∀ഀഀ
"CraftAskNameConfirm"	"¿Seguro que deseas usar este nombre?"਍∀嬀攀渀最氀椀猀栀崀䌀爀愀昀琀䄀猀欀一愀洀攀䌀漀渀昀椀爀洀∀ऀ∀䄀爀攀 礀漀甀 猀甀爀攀 礀漀甀 眀愀渀琀 琀漀 甀猀攀 琀栀椀猀 渀愀洀攀㼀∀ഀഀ
"CraftAskNameWarning"	"(El nombre será permanente y visible para todos)"਍∀嬀攀渀最氀椀猀栀崀䌀爀愀昀琀䄀猀欀一愀洀攀圀愀爀渀椀渀最∀ऀ∀⠀吀栀椀猀 渀愀洀攀 眀椀氀氀 戀攀 瀀甀戀氀椀挀氀礀 瘀椀猀椀戀氀攀 愀渀搀 瀀攀爀洀愀渀攀渀琀⤀∀ഀഀ
"CraftNameConfirm"	"Sí, estoy seguro"਍∀嬀攀渀最氀椀猀栀崀䌀爀愀昀琀一愀洀攀䌀漀渀昀椀爀洀∀ऀ∀夀攀瀀Ⰰ 䤀✀洀 匀甀爀攀℀∀ഀഀ
"CraftInvalidName"	"El nombre no es válido"਍∀嬀攀渀最氀椀猀栀崀䌀爀愀昀琀䤀渀瘀愀氀椀搀一愀洀攀∀ऀ∀䤀渀瘀愀氀椀搀 一愀洀攀℀∀ഀഀ
"CraftInvalidNameDetail"	"Solo se admiten letras, números y espacios"਍∀嬀攀渀最氀椀猀栀崀䌀爀愀昀琀䤀渀瘀愀氀椀搀一愀洀攀䐀攀琀愀椀氀∀ऀ∀伀渀氀礀 氀攀琀琀攀爀猀Ⰰ 渀甀洀戀攀爀猀Ⰰ 愀渀搀 猀瀀愀挀攀猀 愀爀攀 愀氀氀漀眀攀搀∀ഀഀ
"ToolPaintConfirm"	"¿Seguro que deseas pintar el objeto de este color?"਍∀嬀攀渀最氀椀猀栀崀吀漀漀氀倀愀椀渀琀䌀漀渀昀椀爀洀∀ऀ∀䄀爀攀 礀漀甀 猀甀爀攀 礀漀甀 眀愀渀琀 琀漀 瀀愀椀渀琀 琀栀攀 椀琀攀洀 琀栀椀猀 挀漀氀漀爀㼀∀ഀഀ
"ToolPaintConfirmWarning"	"(El color será permanente y visible para todos)"਍∀嬀攀渀最氀椀猀栀崀吀漀漀氀倀愀椀渀琀䌀漀渀昀椀爀洀圀愀爀渀椀渀最∀ऀ∀⠀吀栀椀猀 挀漀氀漀爀 眀椀氀氀 戀攀 瀀甀戀氀椀挀氀礀 瘀椀猀椀戀氀攀 愀渀搀 瀀攀爀洀愀渀攀渀琀⤀∀ഀഀ
"ToolDecodeConfirm"	"¿Seguro que deseas abrir esta caja?"਍∀嬀攀渀最氀椀猀栀崀吀漀漀氀䐀攀挀漀搀攀䌀漀渀昀椀爀洀∀ऀ∀䄀爀攀 礀漀甀 猀甀爀攀 礀漀甀 眀愀渀琀 琀漀 漀瀀攀渀 琀栀椀猀 挀爀愀琀攀㼀∀ഀഀ
"ToolDecodeInProgress"	"Desempaquetando tu recompensa"਍∀嬀攀渀最氀椀猀栀崀吀漀漀氀䐀攀挀漀搀攀䤀渀倀爀漀最爀攀猀猀∀ऀ∀唀渀挀爀愀琀椀渀最 礀漀甀爀 䰀漀漀琀∀ഀഀ
"ToolGiftWrapConfirm"	"¿Seguro que quieres envolver para regalo este objeto?"਍∀嬀攀渀最氀椀猀栀崀吀漀漀氀䜀椀昀琀圀爀愀瀀䌀漀渀昀椀爀洀∀ऀ∀䄀爀攀 礀漀甀 猀甀爀攀 礀漀甀 眀愀渀琀 琀漀 最椀昀琀 眀爀愀瀀 琀栀椀猀 椀琀攀洀㼀∀ഀഀ
"ToolGiftWrapInProgress"	"Envolviendo tu regalo"਍∀嬀攀渀最氀椀猀栀崀吀漀漀氀䜀椀昀琀圀爀愀瀀䤀渀倀爀漀最爀攀猀猀∀ऀ∀圀爀愀瀀瀀椀渀最 礀漀甀爀 䜀椀昀琀∀ഀഀ
"ToolGiftUnwrapInProgress"	"Desenvolviendo el regalo"਍∀嬀攀渀最氀椀猀栀崀吀漀漀氀䜀椀昀琀唀渀眀爀愀瀀䤀渀倀爀漀最爀攀猀猀∀ऀ∀唀渀眀爀愀瀀瀀椀渀最 琀栀攀 䜀椀昀琀∀ഀഀ
"BackpackShowDetails"	"Detalles"਍∀嬀攀渀最氀椀猀栀崀䈀愀挀欀瀀愀挀欀匀栀漀眀䐀攀琀愀椀氀猀∀ऀ∀䐀攀琀愀椀氀猀∀ഀഀ
"Backpack_SortBy_Header"	"Ordenar mochila"਍∀嬀攀渀最氀椀猀栀崀䈀愀挀欀瀀愀挀欀开匀漀爀琀䈀礀开䠀攀愀搀攀爀∀ऀ∀匀漀爀琀 䈀愀挀欀瀀愀挀欀∀ഀഀ
"Backpack_SortBy_Rarity"	"Por aspecto"਍∀嬀攀渀最氀椀猀栀崀䈀愀挀欀瀀愀挀欀开匀漀爀琀䈀礀开刀愀爀椀琀礀∀ऀ∀匀漀爀琀 戀礀 刀愀爀椀琀礀∀ഀഀ
"Backpack_SortBy_Type"	"Por tipo de objeto"਍∀嬀攀渀最氀椀猀栀崀䈀愀挀欀瀀愀挀欀开匀漀爀琀䈀礀开吀礀瀀攀∀ऀ∀匀漀爀琀 戀礀 吀礀瀀攀∀ഀഀ
"Backpack_SortBy_Slot"	"Por espacio equipamiento"਍∀嬀攀渀最氀椀猀栀崀䈀愀挀欀瀀愀挀欀开匀漀爀琀䈀礀开匀氀漀琀∀ऀ∀匀漀爀琀 戀礀 䰀漀愀搀漀甀琀 匀氀漀琀∀ഀഀ
"Codec_MPEG2"	"MPEG-2"਍∀嬀攀渀最氀椀猀栀崀䌀漀搀攀挀开䴀倀䔀䜀㈀∀ऀ∀䴀倀䔀䜀ⴀ㈀∀ഀഀ
"Codec_MPEG4"	"MPEG-4"਍∀嬀攀渀最氀椀猀栀崀䌀漀搀攀挀开䴀倀䔀䜀㐀∀ऀ∀䴀倀䔀䜀ⴀ㐀∀ഀഀ
"Codec_H261"	"H.261"਍∀嬀攀渀最氀椀猀栀崀䌀漀搀攀挀开䠀㈀㘀㄀∀ऀ∀䠀⸀㈀㘀㄀∀ഀഀ
"Codec_H263"	"H.263"਍∀嬀攀渀最氀椀猀栀崀䌀漀搀攀挀开䠀㈀㘀㌀∀ऀ∀䠀⸀㈀㘀㌀∀ഀഀ
"Codec_H264"	"H.264"਍∀嬀攀渀最氀椀猀栀崀䌀漀搀攀挀开䠀㈀㘀㐀∀ऀ∀䠀⸀㈀㘀㐀∀ഀഀ
"Codec_MJPEG_A"	"Motion JPEG A"਍∀嬀攀渀最氀椀猀栀崀䌀漀搀攀挀开䴀䨀倀䔀䜀开䄀∀ऀ∀䴀漀琀椀漀渀 䨀倀䔀䜀 䄀∀ഀഀ
"Codec_MJPEG_B"	"Motion JPEG B"਍∀嬀攀渀最氀椀猀栀崀䌀漀搀攀挀开䴀䨀倀䔀䜀开䈀∀ऀ∀䴀漀琀椀漀渀 䨀倀䔀䜀 䈀∀ഀഀ
"Codec_SORENSON3"	"Sorenson 3"਍∀嬀攀渀最氀椀猀栀崀䌀漀搀攀挀开匀伀刀䔀一匀伀一㌀∀ऀ∀匀漀爀攀渀猀漀渀 ㌀∀ഀഀ
"Codec_CINEPACK"	"Cinepack"਍∀嬀攀渀最氀椀猀栀崀䌀漀搀攀挀开䌀䤀一䔀倀䄀䌀䬀∀ऀ∀䌀椀渀攀瀀愀挀欀∀ഀഀ
"Codec_WEBM"	"WebM"਍∀嬀攀渀最氀椀猀栀崀䌀漀搀攀挀开圀䔀䈀䴀∀ऀ∀圀攀戀䴀∀ഀഀ
}਍紀ഀഀ
